HE - THE, SHE, CACHE, APACHE, PORSCHE, DEUTSCHE
ND - AND, FIND, SEND, FOUND, END, AROUND, SECOND, FRIEND, HAND, LAND
ES - SERVICES, DOES, GAMES, STATES, PRICES, PAGES, RESOURCES, PICTURES, TIMES, SITES
ER - OTHER, OVER, HER, NUMBER, AFTER, ORDER, USER, UNDER, CENTER, MEMBER
NG - USING, SHIPPING, LONG, BEING, FOLLOWING, INCLUDING, RATING, DURING, SHOPPING, LISTING
ED - USED, NEED, UNITED, POSTED, RESERVED, BASED, RELATED, ADVANCED, PROVIDED, REQUIRED
ON - INFORMATION, EDUCATION, VERSION, SECTION, LOCATION, DESCRIPTION, NON, ACTION, APPLICATION, PERSON
RE - ARE, MORE, THERE, HERE, WERE, SOFTWARE, WHERE, STORE, BEFORE, CARE
AL - GENERAL, REAL, INTERNATIONAL, LOCAL, NATIONAL, SPECIAL, TOTAL, PERSONAL, DIGITAL, MEDICAL
OR - FOR, AUTHOR, MAJOR, COLOR, DIRECTOR, ERROR, EDITOR, PRIOR, SENIOR, DOOR
TS - ITS, PRODUCTS, RIGHTS, COMMENTS, RESULTS, SPORTS, POSTS, STUDENTS, EVENTS, REPORTS
NT - MANAGEMENT, DEVELOPMENT, WANT, CURRENT, GOVERNMENT, ACCOUNT, DEPARTMENT, CONTENT, DIFFERENT, PRINT
ST - FIRST, LIST, JUST, LAST, MOST, POST, BEST, MUST, WEST, COST
LL - ALL, WILL, WELL, FULL, SMALL, CALL, SHALL, STILL, SELL, CELL
CE - SERVICE, PRICE, OFFICE, PLACE, SINCE, INSURANCE, SOURCE, SCIENCE, PERFORMANCE, EXPERIENCE
LE - PEOPLE, AVAILABLE, FILE, WHILE, PROFILE, TITLE, LITTLE, ARTICLE, SALE, TABLE
TE - SITE, DATE, STATE, WEBSITE, WHITE, RATE, PRIVATE, ESTATE, NOTE, COMPLETE
SE - USE, THESE, PLEASE, BECAUSE, THOSE, CASE, HOUSE, COURSE, BROWSE, RELEASE
TH - WITH, HEALTH, SOUTH, BOTH, NORTH, MONTH, DEATH, GROWTH, LENGTH, SMITH
AT - THAT, WHAT, GREAT, FORMAT, CHAT, SAT, FAT, CAT, FLAT, HEAT
AN - CAN, THAN, JAN, AMERICAN, MAN, PLAN, HUMAN, SAN, LOAN, JAPAN
RS - YEARS, MEMBERS, HOURS, USERS, OFFERS, COMPUTERS, OTHERS, CARS, CUSTOMERS, ORDERS
RY - VERY, JANUARY, HISTORY, DIRECTORY, EVERY, COUNTRY, CATEGORY, GALLERY, LIBRARY, INDUSTRY
ME - HOME, TIME, SOME, NAME, SAME, GAME, COME, BECOME, WELCOME, INCOME
EN - WHEN, BEEN, THEN, BETWEEN, EVEN, WOMEN, OPEN, CHILDREN, TEEN, MEN
LY - ONLY, FAMILY, REPLY, REALLY, JULY, DAILY, EARLY, USUALLY, CURRENTLY, APPLY
VE - HAVE, LOVE, SAVE, LIVE, ABOVE, GIVE, ARCHIVE, DRIVE, FIVE, RECEIVE
IS - THIS, HIS, ANALYSIS, BASIS, PARIS, CHRIS, ILLINOIS, LOUIS, GRATIS, DAVIS
NS - CONDITIONS, QUESTIONS, OPTIONS, SOLUTIONS, MEANS, APPLICATIONS, LOANS, PLANS, TEENS, RETURNS
GE - PAGE, MESSAGE, CHANGE, IMAGE, COLLEGE, LARGE, LANGUAGE, AGE, RANGE, AVERAGE
CH - SEARCH, WHICH, SUCH, EACH, RESEARCH, MUCH, MARCH, BEACH, TECH, WATCH
NE - ONE, ONLINE, LINE, PHONE, JUNE, DONE, MAGAZINE, NONE, ENGINE, SOMEONE
TY - CITY, UNIVERSITY, COMMUNITY, SECURITY, COUNTY, PROPERTY, QUALITY, PARTY, SOCIETY, SAFETY
AY - MAY, DAY, WAY, EBAY, TODAY, GAY, SAY, PLAY, PAY, AWAY
UT - ABOUT, BUT, OUT, WITHOUT, PUT, CUT, INPUT, OUTPUT, THROUGHOUT, CHECKOUT
UR - YOUR, OUR, FOUR, EUR, TOUR, HOUR, AMATEUR, COLOUR, VOYEUR, OCCUR
AS - WAS, HAS, TEXAS, AREAS, GAS, CHRISTMAS, IDEAS, THOMAS, CAMERAS, LAS
OT - NOT, HOT, GOT, LOT, ROOT, SHOT, FOOT, FORGOT, SPOT, DOT
SS - BUSINESS, ADDRESS, ACCESS, CLASS, PRESS, PROCESS, LESS, RSS, WIRELESS, LOSS
CT - CONTACT, PRODUCT, SUBJECT, PROJECT, SELECT, ACT, OCT, DIRECT, DISTRICT, FACT
OM - FROM, ROOM, KINGDOM, COM, CUSTOM, TOM, BOTTOM, RANDOM, FREEDOM, ATOM
ET - GET, SET, INTERNET, MARKET, STREET, LET, YET, NET, MEET, CNET
CK - CLICK, BACK, BLACK, CHECK, STOCK, FEEDBACK, TRACK, ROCK, QUICK, PACK
OU - YOU, THOU, LOU
LD - WOULD, WORLD, SHOULD, COULD, OLD, FIELD, CHILD, GOLD, BUILD, HELD
EW - NEW, VIEW, REVIEW, FEW, OVERVIEW, INTERVIEW, KNEW, ANDREW, PREVIEW, CREW
RT - SUPPORT, PART, REPORT, ART, START, CART, COURT, SHORT, HEART, SORT
OW - NOW, HOW, KNOW, SHOW, LOW, BELOW, WINDOW, YELLOW, FOLLOW, ALLOW
IC - MUSIC, PUBLIC, TOPIC, SPECIFIC, ECONOMIC, BASIC, ELECTRONIC, CLASSIC, TRAFFIC, REPUBLIC
DS - NEEDS, CARDS, FRIENDS, RECORDS, DOWNLOADS, KIDS, WORDS, METHODS, STANDARDS, ISLANDS
AR - YEAR, CAR, WAR, STAR, SIMILAR, POPULAR, MAR, CALENDAR, FAR, CLEAR
IN - WITHIN, MAIN, JOIN, AGAIN, LOGIN, DOMAIN, CERTAIN, WIN, BIN, SKIN
LS - DETAILS, HOTELS, TOOLS, GIRLS, SCHOOLS, DEALS, MODELS, MATERIALS, SKILLS, LEVELS
EE - FREE, SEE, THREE, COMMITTEE, DEGREE, TREE, FEE, AGREE, EMPLOYEE, LEE
DE - MADE, CODE, GUIDE, INCLUDE, PROVIDE, SIDE, TRADE, NUDE, WIDE, INSIDE
AD - HAD, READ, DOWNLOAD, THREAD, ROAD, HEAD, BAD, LEAD, INSTEAD, DEAD
EL - HOTEL, TRAVEL, LEVEL, MODEL, FEEL, MICHAEL, CHANNEL, TEL, PANEL, STEEL
MS - ITEMS, TERMS, SYSTEMS, FORUMS, PROGRAMS, PROBLEMS, ROOMS, FORMS, SEEMS, CLAIMS
RD - BOARD, CARD, STANDARD, PASSWORD, HARD, RECORD, WORD, THIRD, AWARD, FORWARD
NY - ANY, COMPANY, MANY, GERMANY, SONY, FUNNY, TONY, TINY, ANTHONY, TIFFANY
EY - THEY, MONEY, KEY, SURVEY, VALLEY, JERSEY, ATTORNEY, TURKEY, HEY, DISNEY
KS - BOOKS, LINKS, WORKS, THANKS, WEEKS, NETWORKS, TRADEMARKS, LOOKS, BANKS, PARKS
HT - COPYRIGHT, RIGHT, NIGHT, LIGHT, MIGHT, WEIGHT, THOUGHT, BROUGHT, FLIGHT, EIGHT
IL - EMAIL, MAIL, APRIL, UNTIL, COUNCIL, OIL, RETAIL, CIVIL, DETAIL, FAIL
KE - LIKE, MAKE, TAKE, LAKE, MIKE, BIKE, STRIKE, SMOKE, CAKE, DICKE
WS - NEWS, REVIEWS, WINDOWS, SHOWS, VIEWS, ALLOWS, LAWS, FOLLOWS, KNOWS, INTERVIEWS
IA - MEDIA, CALIFORNIA, AUSTRALIA, VIA, INDIA, VIRGINIA, NOKIA, ASIA, GEORGIA, COLUMBIA
IT - VISIT, CREDIT, EDIT, UNIT, SUBMIT, BIT, KIT, HIT, BENEFIT, FIT
EM - THEM, SYSTEM, ITEM, PROBLEM, SEEM, HOLDEM, MODEM, EMINEM, STEM, OEM
US - PREVIOUS, STATUS, PLUS, VARIOUS, FOCUS, THUS, CAMPUS, BUS, SERIOUS, VIRUS
ID - SAID, DID, DAVID, BID, PAID, VALID, AID, MID, SOLID, AVOID
RK - WORK, NETWORK, YORK, PARK, MARK, DARK, FRAMEWORK, BOOKMARK, TRADEMARK, CLARK
IR - THEIR, AIR, HAIR, REPAIR, FAIR, CHAIR, PAIR, SIR, DIR, BLAIR
OD - GOOD, FOOD, GOD, PERIOD, METHOD, BLOOD, WOOD, IPOD, NEIGHBORHOOD, HOLLYWOOD
GS - THINGS, LISTINGS, RATINGS, SONGS, BLOGS, SETTINGS, MEETINGS, DRUGS, TAGS, SAVINGS
UE - VALUE, ISSUE, BLUE, DUE, TRUE, CONTINUE, TUE, UNIQUE, LEAGUE, AVENUE
CY - POLICY, PRIVACY, AGENCY, EMERGENCY, CURRENCY, FREQUENCY, ACCURACY, PHARMACY, PREGNANCY, EFFICIENCY
OP - TOP, SHOP, STOP, DEVELOP, POP, DESKTOP, DROP, WORKSHOP, LAPTOP, HOP
SH - ENGLISH, CASH, WISH, BUSH, BRITISH, FLASH, FISH, SPANISH, FRESH, FINISH
RN - RETURN, LEARN, PORN, TURN, WESTERN, MODERN, NORTHERN, BORN, SOUTHERN, EASTERN
GH - HIGH, THROUGH, THOUGH, ENOUGH, ALTHOUGH, PITTSBURGH, EDINBURGH, TOUGH, ROUGH, LAUGH
AM - PROGRAM, TEAM, WILLIAM, STREAM, DREAM, SPAM, CREAM, CAM, RAM, SAM
OL - SCHOOL, CONTROL, TOOL, COOL, POOL, VOL, PROTOCOL, ALCOHOL, AOL, SYMBOL
YS - DAYS, ALWAYS, SAYS, TOYS, WAYS, BOYS, HOLIDAYS, GUYS, KEYS, PLAYS
PS - GROUPS, TIPS, MAPS, SHIPS, PERHAPS, STEPS, SHOPS, CLIPS, UPS, RELATIONSHIPS
TO - INTO, PHOTO, AUTO, TORONTO, ONTO, PUERTO, SACRAMENTO, FOTO, GOTO, UNTO
CS - ELECTRONICS, TOPICS, LYRICS, PICS, STATISTICS, GRAPHICS, POLITICS, ECONOMICS, COMICS, PHYSICS
UM - FORUM, ALBUM, MAXIMUM, MEDIUM, MINIMUM, MUSEUM, CUM, PREMIUM, ZUM, CURRICULUM
WN - OWN, DOWN, TOWN, KNOWN, SHOWN, BROWN, UNKNOWN, DOWNTOWN, CROWN, DRAWN
NK - LINK, THINK, BANK, THANK, PINK, RANK, FRANK, DRINK, PERMALINK, INK
PE - TYPE, EUROPE, HOPE, RAPE, TAPE, CAPE, RECIPE, SHAPE, SCOPE, LANDSCAPE
TA - DATA, SANTA, MINNESOTA, ATLANTA, DAKOTA, BETA, DELTA, COSTA, TOYOTA, ALBERTA
DY - STUDY, BODY, ALREADY, READY, LADY, BUDDY, COMEDY, ANDY, EVERYBODY, NOBODY
EB - WEB, FEB, VOYEURWEB
IP - ZIP, SHIP, MEMBERSHIP, TRIP, RELATIONSHIP, SKIP, LEADERSHIP, CLIP, PARTNERSHIP, TIP
OK - BOOK, LOOK, TOOK, COOK, NOTEBOOK, OUTLOOK, HANDBOOK, GUESTBOOK, HOOK, EBOOK
EX - SEX, INDEX, COMPLEX, ALEX, LATEX, ESSEX, ANNEX, LIVESEX, WORLDSEX, SUSSEX
RM - FORM, TERM, FARM, FIRM, PLATFORM, PERFORM, ARM, REFORM, CONFIRM, WARM
XT - NEXT, TEXT, CONTEXT, EXT
HO - WHO, IDAHO, ECHO, CHO
