TH - THE, THAT, THIS, THEY, THEIR, THERE, THESE, THAN, THEM, THEN
AN - AND, ANY, ANOTHER, ANALYSIS, ANNUAL, ANYTHING, ANYONE, ANSWER, ANIMAL, ANTI
CO - CONTACT, COPYRIGHT, COMPANY, COULD, COMMENTS, COMMUNITY, CODE, COUNTY, COMPUTER, CONTROL
RE - REVIEW, READ, RESEARCH, REVIEWS, REAL, REPORT, RESULTS, RESERVED, RELATED, RESOURCES
PR - PRICE, PRODUCTS, PRODUCT, PRIVACY, PROGRAM, PRICES, PROJECT, PROFILE, PREVIOUS, PROPERTY
FO - FOR, FORUM, FOUND, FOLLOWING, FORM, FOOD, FORUMS, FOUR, FORMAT, FORCE
SE - SEARCH, SEE, SERVICES, SERVICE, SEX, SET, SEND, SECTION, SECURITY, SELECT
IN - INFORMATION, INTO, INFO, INTERNATIONAL, INTERNET, INDEX, INCLUDING, INSURANCE, INCLUDE, INDUSTRY
MA - MAY, MAKE, MANY, MAIL, MAP, MANAGEMENT, MADE, MAIN, MAN, MARKET
WI - WITH, WILL, WITHIN, WITHOUT, WINDOWS, WINDOW, WIDE, WIRELESS, WISH, WIN
CA - CAN, CAR, CASE, CARE, CALL, CARD, CANADA, CATEGORIES, CATEGORY, CART
ST - STATE, STORE, STATES, STUDENTS, STILL, STOCK, START, STUDY, STAFF, STREET
YO - YOU, YOUR, YORK, YOUNG, YOURSELF, YOUTH, YOURS, YOGA, YOUNGER, YORKSHIRE
DE - DEVELOPMENT, DETAILS, DESIGN, DEPARTMENT, DESCRIPTION, DECEMBER, DEC, DELIVERY, DEALS, DESIGNED
PA - PAGE, PART, PAGES, PARTY, PAYMENT, PARK, PAPER, PASSWORD, PAY, PAST
NO - NOT, NOW, NORTH, NON, NOTE, NOVEMBER, NOV, NOTICE, NONE, NOTES
MO - MORE, MOST, MONEY, MOVIES, MODEL, MOVIE, MOBILE, MONTH, MONTHS, MODELS
LI - LIKE, LIST, LINKS, LIFE, LINE, LINK, LISTING, LITTLE, LIVE, LIBRARY
HO - HOME, HOW, HOTEL, HOTELS, HOUSE, HOURS, HOWEVER, HOT, HOSTING, HOLIDAY
NE - NEW, NEWS, NEXT, NEED, NETWORK, NEVER, NEEDS, NET, NEWSLETTER, NEAR
HA - HAVE, HAS, HAD, HARD, HAND, HAVING, HALF, HARDWARE, HAPPY, HALL
AR - ARE, AREA, ART, ARTICLE, AROUND, ARTICLES, AREAS, ARCHIVE, ARTS, ARCHIVES
FR - FROM, FREE, FRIEND, FRIENDS, FRANCE, FRONT, FRIDAY, FRENCH, FRI, FRIENDLY
PO - POST, POLICY, POSTED, POWER, POSTS, POINT, POKER, POSSIBLE, PORN, POPULAR
WH - WHAT, WHICH, WHEN, WHO, WHERE, WHILE, WHITE, WHY, WHETHER, WHOLE
BE - BEEN, BEST, BEFORE, BECAUSE, BETWEEN, BEING, BETTER, BELOW, BECOME, BEACH
AL - ALL, ALSO, ALWAYS, ALREADY, ALONG, ALTHOUGH, ALBUM, ALLOW, ALMOST, ALTERNATIVE
DI - DID, DIRECTORY, DIGITAL, DIFFERENT, DISCUSSION, DISPLAY, DIRECTOR, DIRECT, DISTRICT, DISCOUNT
ME - MESSAGE, MEMBER, MEMBERS, MEDIA, MEN, MEDICAL, MEMORY, MEETING, MESSAGES, MEANS
FI - FIRST, FIND, FILE, FINANCIAL, FIELD, FILES, FILM, FIVE, FINAL, FINANCE
SU - SUCH, SUPPORT, SUBJECT, SUN, SURE, SUBSCRIBE, SUBMIT, SUMMARY, SUPPLIES, SUNDAY
WA - WAS, WAY, WANT, WATER, WAR, WASHINGTON, WATCH, WANTED, WALL, WARNING
CH - CHECK, CHANGE, CHILDREN, CHANGES, CHINA, CHILD, CHEAP, CHOOSE, CHAPTER, CHURCH
LO - LOCAL, LONG, LOCATION, LOVE, LOW, LOOK, LOOKING, LOGIN, LONDON, LOG
SH - SHOULD, SHE, SHIPPING, SHOW, SHOP, SHOPPING, SHALL, SHARE, SHORT, SHOWS
SO - SOME, SOFTWARE, SOUTH, SOURCE, SOCIAL, SOMETHING, SOCIETY, SOLUTIONS, SOUND, SORT
HE - HERE, HELP, HEALTH, HER, HEAD, HEART, HELD, HEAR, HELPFUL, HEARD
WE - WEB, WERE, WELL, WEBSITE, WEST, WEEK, WELCOME, WEATHER, WEIGHT, WESTERN
SI - SITE, SIGN, SIZE, SINCE, SITES, SIDE, SINGLE, SIMILAR, SIMPLE, SILVER
BU - BUT, BUSINESS, BUY, BUILDING, BUILD, BUSH, BUTTON, BUILT, BUDGET, BUYING
TE - TERMS, TECHNOLOGY, TEXT, TEEN, TEAM, TEST, TEXAS, TERM, TELL, TECHNICAL
TR - TRAVEL, TRAINING, TRY, TRACK, TRADE, TRUE, TREATMENT, TRANSFER, TREE, TRYING
TO - TOP, TODAY, TOTAL, TOOLS, TOO, TOPIC, TOPICS, TOGETHER, TOWN, TOYS
WO - WOULD, WORLD, WORK, WOMEN, WORKING, WORD, WORKS, WORDS, WOMAN, WORLDWIDE
BA - BACK, BASED, BABY, BAD, BANK, BASIC, BASE, BAY, BAR, BAND
SA - SAID, SAME, SAVE, SALE, SALES, SAY, SAN, SAFETY, SAYS, SAT
LA - LAST, LAW, LARGE, LANGUAGE, LATEST, LAND, LAKE, LATER, LATE, LARGER
DA - DATE, DAY, DATA, DAYS, DAVID, DAILY, DATABASE, DATING, DANCE, DARK
LE - LEVEL, LEARN, LEFT, LESS, LET, LEGAL, LEARNING, LEAST, LEAVE, LESBIAN
PE - PEOPLE, PER, PERSONAL, PERSON, PERFORMANCE, PERIOD, PERCENT, PERFECT, PETER, PEACE
AD - ADD, ADDRESS, ADVANCED, ADDITIONAL, ADDED, ADULT, ADVERTISING, ADVERTISE, ADMINISTRATION, ADDITION
AC - ACCESS, ACCOUNT, ACTION, ACCESSORIES, ACT, ACTIVITIES, ACTIVE, ACTIVITY, ACROSS, ACCORDING
US - USE, USED, USER, USING, USA, USERS, USUALLY, USR, USEFUL, USES
BO - BOOKS, BOOK, BOTH, BOARD, BOX, BODY, BOY, BOYS, BOARDS, BORN
EX - EXPERIENCE, EXAMPLE, EXCHANGE, EXECUTIVE, EXCELLENT, EXPRESS, EXTRA, EXISTING, EXPECTED, EXCEPT
ON - ONE, ONLY, ONLINE, ONCE, ONES, ONTARIO, ONTO, ONGOING, ONS, ONION
VI - VIEW, VIDEO, VISIT, VIA, VIDEOS, VIEWS, VIRGINIA, VIRTUAL, VISUAL, VISITORS
EN - END, ENGLISH, ENTER, ENERGY, ENTERTAINMENT, ENVIRONMENT, ENGINEERING, ENOUGH, ENVIRONMENTAL, ENTRY
FA - FAMILY, FAX, FAQ, FAST, FACT, FAR, FACE, FACILITIES, FALL, FAVORITE
CL - CLICK, CLASS, CLUB, CLOSE, CLEAR, CLOTHING, CLIENT, CLASSIC, CLASSES, CLEAN
MI - MIGHT, MILLION, MICROSOFT, MILES, MINUTES, MICHAEL, MIND, MILITARY, MIDDLE, MINI
SP - SPECIAL, SPORTS, SPACE, SPECIFIC, SPEED, SPONSORED, SPRING, SPORT, SPAIN, SPECIFIED
DO - DOES, DOWN, DOWNLOAD, DONE, DOWNLOADS, DOCUMENT, DOMAIN, DOING, DOUBLE, DOG
HI - HIS, HIGH, HIM, HISTORY, HIGHER, HILL, HIT, HITS, HIGHEST, HIGHLY
PL - PLEASE, PLACE, PLAN, PLAY, PLANNING, PLUS, PLAYER, PLAYERS, PLANS, PLANT
OU - OUR, OUT, OUTSIDE, OUTPUT, OUTDOOR, OUTDOORS, OUTLET, OUTSTANDING, OUTLOOK, OUTCOMES
UN - UNDER, UNIVERSITY, UNITED, UNTIL, UNIT, UNION, UNIQUE, UNDERSTAND, UNITS, UNLESS
GR - GROUP, GREAT, GROUPS, GREEN, GROWTH, GROUND, GRAND, GREATER, GRAPHICS, GRADE
TI - TIME, TIMES, TITLE, TICKETS, TIPS, TITLES, TITS, TIP, TICKET, TIM
GE - GET, GENERAL, GETTING, GERMANY, GEORGE, GERMAN, GETS, GEORGIA, GEAR, GENERALLY
RA - RATING, RATE, RATES, RANGE, RADIO, RATHER, RATINGS, RATED, RACE, RAPE
AB - ABOUT, ABOVE, ABLE, ABSTRACT, ABILITY, ABUSE, ABSOLUTELY, ABC, ABSOLUTE, ABROAD
GO - GOOD, GOVERNMENT, GOING, GOT, GOD, GOLD, GOLF, GOOGLE, GOODS, GOES
BR - BROWSE, BRAND, BRITISH, BROWSER, BROWN, BRING, BRANDS, BREAK, BREAST, BROUGHT
FE - FEATURES, FEEDBACK, FEW, FEBRUARY, FEB, FEDERAL, FEEL, FEATURED, FEMALE, FEATURE
SC - SCHOOL, SCIENCE, SCHOOLS, SCREEN, SCORE, SCHEDULE, SCALE, SCIENCES, SCIENTIFIC, SCOTT
TA - TAKE, TABLE, TAX, TALK, TAKEN, TAKING, TAKES, TARGET, TASK, TAGS
AP - APPLICATION, APRIL, APPLICATIONS, APR, APPLY, APPROPRIATE, APPROACH, APPROVED, APPLE, APPLIED
GA - GAMES, GAME, GAY, GALLERY, GARDEN, GAS, GALLERIES, GAVE, GAMMA, GAIN
NA - NAME, NATIONAL, NATURAL, NATURE, NAMES, NAVIGATION, NATION, NAKED, NATIVE, NAMED
RO - ROOM, ROAD, ROCK, ROLE, ROBERT, ROOMS, ROUND, ROYAL, ROOT, ROSE
PU - PUBLIC, PUT, PUBLISHED, PURCHASE, PURPOSE, PUBLICATIONS, PUBLISHER, PUSSY, PUBLICATION, PURPOSES
FU - FULL, FUTURE, FURTHER, FUN, FUNCTION, FURNITURE, FUND, FUNDS, FUNCTIONS, FULLY
PH - PHONE, PHOTO, PHOTOS, PHONES, PHYSICAL, PHOTOGRAPHY, PHP, PHENTERMINE, PHASE, PHILADELPHIA
AU - AUTHOR, AUGUST, AUDIO, AUSTRALIA, AUG, AUTO, AUTHORITY, AUTHORS, AUSTRALIAN, AUCTION
MU - MUSIC, MUST, MUCH, MULTIPLE, MULTI, MUSEUM, MUSICAL, MULTIMEDIA, MUSCLE, MUNICIPAL
EV - EVEN, EVENTS, EVERY, EVENT, EVER, EVERYTHING, EVERYONE, EVIDENCE, EVALUATION, EVENING
JO - JOHN, JOBS, JOB, JOIN, JOURNAL, JOINED, JOHNSON, JONES, JOINT, JOE
RI - RIGHTS, RIGHT, RISK, RIVER, RING, RICHARD, RINGTONES, RICH, RISE, RINGS
IT - ITS, ITEMS, ITEM, ITALY, ITSELF, ITALIAN, ITUNES, ITALIANO, ITALIC, ITALIA
OF - OFF, OFFICE, OFFERS, OFFER, OFFICIAL, OFTEN, OFFERED, OFFICER, OFFERING, OFFICES
CR - CREDIT, CREATE, CREATED, CROSS, CREATIVE, CRITICAL, CRIME, CREATING, CREEK, CRIMINAL
AS - ASSOCIATION, ASK, ASKED, ASIAN, ASSOCIATED, ASS, ASSESSMENT, ASIA, ASSISTANCE, ASSOCIATES
JU - JUST, JUNE, JULY, JUL, JUN, JUSTICE, JUMP, JUDGE, JUNIOR, JUDGMENT
JA - JAN, JANUARY, JAMES, JAPAN, JAVA, JAPANESE, JACK, JACKSON, JAZZ, JAVASCRIPT
QU - QUALITY, QUESTIONS, QUOTE, QUESTION, QUICK, QUITE, QUOTES, QUICKLY, QUANTITY, QUARTER
YE - YEAR, YEARS, YES, YET, YELLOW, YESTERDAY, YEAH, YEA, YEMEN, YEAST
CE - CENTER, CENTRAL, CELL, CENTRE, CERTAIN, CENTURY, CELLS, CERTIFICATE, CERTIFIED, CENTERS
BI - BIG, BILL, BIT, BID, BIN, BIBLE, BIRTH, BINDING, BILLION, BIRTHDAY
CU - CURRENT, CUSTOMER, CURRENTLY, CUSTOMERS, CULTURE, CUSTOM, CUT, CUP, CURRENCY, CUM
