VH - VHS
DF - PDF
HP - PHP
OH - OHIO
XO - SEXO
XB - XBOX
HZ - MHZ, GHZ
UY - BUY, GUY
WW - WWW, WWW
MT - GMT, MTV
TD - LTD, STD
ZU - ZUM, ZUS
XX - XXX, XNXX
OI - OIL, OILS
LP - LLP, HELP
VD - DVD, BLVD
ZZ - JAZZ, BUZZ
SD - USD, FREEBSD
SR - USR, SRC, SRI
BC - BBC, ABC, NBC
IZ - BIZ, LIZ, QUIZ
TP - FTP, HTTP, SMTP
VS - CVS, TVS, VSNET
QL - SQL, QLD, MYSQL
PG - JPG, RPG, MPG, PGP
DT - PDT, EDT, CDT, DTS
PD - PDF, PDA, PDT, PDAS
DD - ADD, ODD, DDR, TODD
PM - RPM, PMC, PPM, PMID
LC - LLC, LCD, PLC, OCLC
EI - EIGHT, EITHER, BRUNEI
PC - PCS, PCI, PPC, PCT, UPC
VY - NAVY, LEVY, HEAVY, CHEVY
ML - XML, MLB, MLS, HTML, XHTML
KO - KONG, KOREA, KODAK, KOREAN
NN - INN, ANN, CNN, LYNN, PENN, GLENN
LM - FILM, PALM, CALM, REALM, STOCKHOLM
AA - AAA, AAA, NCAA, NCAA, AARON, AARON
OA - OAK, SOA, OAKS, OASIS, SAMOA, OAKLAND
SQ - SQL, SQUAD, SQUARE, SQUIRT, SQUIRTING
UA - AQUA, PAPUA, JOSHUA, ANTIGUA, NICARAGUA
EK - WEEK, SEEK, TREK, GEEK, CREEK, GREEK, DEREK
EB - WEB, FEB, EBAY, EBONY, EBOOK, EBOOKS, VOYEURWEB
OO - TOO, ZOO, OOO, FOO, OOPS, YAHOO, KELKOO, TATTOO
EO - CEO, SEO, LEO, GEO, NEO, EOS, TREO, VIDEO, STEREO
ZO - ZOO, ZONE, ZOOM, ZOPE, ZONES, ZONING, ZOLOFT, ZOOPHILIA
MP - MPH, AMP, JUMP, CAMP, PUMP, MPEG, LAMP, TEMP, COMP, STAMP
SK - ASK, SKI, SKY, RISK, SKIN, SKIP, TASK, DISK, DESK, SKILLS
SA - USA, SAY, SAN, SAID, SAME, SAVE, SALE, SAYS, SALES, SAFETY
GN - GNU, SIGN, GNOME, ALIGN, DESIGN, ASSIGN, FOREIGN, CAMPAIGN
YA - YARD, YALE, YANG, YARN, YAHOO, YARDS, KENYA, YACHT, YAMAHA
UR - OUR, URL, EUR, YOUR, FOUR, TOUR, HOUR, URBAN, COLOUR, AMATEUR
AN - AND, CAN, ANY, JAN, MAN, THAN, PLAN, HUMAN, ANOTHER, AMERICAN
YE - YES, YET, EYE, AYE, YEA, YEAR, YEAH, YEARS, YELLOW, YESTERDAY
NO - NOT, NOW, NON, NOV, NOTE, NONE, NORTH, NOTES, NOTICE, NOVEMBER
NE - NEW, ONE, NEWS, NEXT, NEED, LINE, JUNE, PHONE, ONLINE, NETWORK
TH - THE, THAT, THIS, WITH, THEY, THAN, THEIR, THERE, THESE, HEALTH
MA - MAY, MAP, MAN, MAKE, MANY, MAIL, MADE, MAIN, MARKET, MANAGEMENT
AR - ARE, CAR, ART, WAR, YEAR, AREA, STAR, AROUND, ARTICLE, ARTICLES
TO - TOP, TOO, INTO, AUTO, TODAY, PHOTO, TOTAL, TOOLS, TOPIC, TOPICS
IT - ITS, BIT, ITEM, EDIT, UNIT, ITEMS, VISIT, ITALY, CREDIT, SUBMIT
WH - WHO, WHY, WHAT, WHEN, WHICH, WHERE, WHILE, WHITE, WHOLE, WHETHER
EP - SEP, EPA, REP, KEEP, STEP, DEEP, SLEEP, EPSON, EPISODE, EPINIONS
SN - MSN, ASN, MSN, SNOW, SNAP, ISSN, SNOW, SNAKE, SNAPSHOT, SNOWBOARD
HI - HIS, HIM, HIT, HIGH, HILL, HITS, HIGHER, HIGHLY, HISTORY, HIGHEST
EN - END, WHEN, BEEN, THEN, EVEN, OPEN, TEEN, WOMEN, BETWEEN, CHILDREN
TI - TIP, TIME, TIPS, ANTI, TITS, TIMES, TITLE, MULTI, TITLES, TICKETS
PS - PST, UPS, TIPS, MAPS, SHIPS, STEPS, SHOPS, CLIPS, GROUPS, PERHAPS
YS - DAYS, SAYS, TOYS, WAYS, BOYS, GUYS, KEYS, PLAYS, ALWAYS, HOLIDAYS
OX - BOX, FOX, COX, SOX, XBOX, OXFORD, OXYGEN, APPROX, FIREFOX, TOOLBOX
WO - TWO, WORK, WORD, WOULD, WORLD, WOMEN, WORKS, WORDS, WOMAN, WORKING
JU - JUL, JUN, JUST, JUNE, JULY, JUMP, JUDGE, JUNIOR, JUSTICE, JUDGMENT
US - USE, USA, USED, USER, PLUS, USING, USERS, STATUS, USUALLY, PREVIOUS
PA - PAY, PAGE, PART, PARK, PAST, PAGES, PARTY, PAPER, PAYMENT, PASSWORD
ER - HER, OVER, USER, OTHER, AFTER, ORDER, UNDER, NUMBER, CENTER, MEMBER
FA - FAX, FAQ, FAR, FAST, FACT, FACE, FALL, FAMILY, FAVORITE, FACILITIES
AW - LAW, SAW, RAW, AWAY, DRAW, AWARD, AWARE, AWARDS, AWARDED, AWARENESS
EE - SEE, FEE, LEE, FREE, TREE, THREE, AGREE, DEGREE, EMPLOYEE, COMMITTEE
FY - NOTIFY, MODIFY, VERIFY, SPECIFY, QUALIFY, SATISFY, JUSTIFY, IDENTIFY
GA - GAY, GAS, GAME, GAVE, GAIN, GAMES, GAMMA, GARDEN, GALLERY, GALLERIES
CA - CAN, CAR, CASE, CARE, CALL, CARD, CART, CANADA, CATEGORY, CATEGORIES
YO - YOU, YOUR, YORK, YOGA, YOUNG, YOUTH, YOURS, TOKYO, YOUNGER, YOURSELF
WN - OWN, DOWN, TOWN, KNOWN, SHOWN, BROWN, CROWN, DRAWN, UNKNOWN, DOWNTOWN
EY - KEY, EYE, THEY, EYES, MONEY, SURVEY, VALLEY, JERSEY, TURKEY, ATTORNEY
OL - OLD, VOL, TOOL, COOL, POOL, OLDER, SCHOOL, CONTROL, ALCOHOL, PROTOCOL
SI - SITE, SIGN, SIZE, SIDE, SINCE, SITES, SINGLE, SIMPLE, SILVER, SIMILAR
RE - ARE, MORE, HERE, WERE, READ, THERE, WHERE, REVIEW, SOFTWARE, RESEARCH
NY - ANY, MANY, SONY, TONY, TINY, FUNNY, COMPANY, GERMANY, ANTHONY, TIFFANY
LT - LTD, FELT, SALT, BELT, ADULT, BUILT, FAULT, RESULT, DEFAULT, DIFFICULT
MO - MORE, MOST, MONEY, MODEL, MOVIE, MONTH, MOVIES, MOBILE, MONTHS, MODELS
AH - UTAH, YEAH, BLAH, AHEAD, SARAH, ALLAH, AHEAD, MARIAH, DEBORAH, SAVANNAH
UT - BUT, OUT, PUT, CUT, ABOUT, INPUT, OUTPUT, WITHOUT, CHECKOUT, THROUGHOUT
LF - SELF, GOLF, HALF, MILF, GULF, ITSELF, MYSELF, BEHALF, HIMSELF, YOURSELF
NI - NICE, MINI, NINE, NICK, NIGHT, NIKON, NIGHTS, ALUMNI, NIPPLES, NINTENDO
OS - LOS, DOS, LOGOS, FOTOS, LYCOS, PHOTOS, VIDEOS, DILDOS, CASINOS, STUDIOS
AI - AIR, AID, AIM, AIDS, THAI, HENTAI, AIRPORT, AIRLINE, AIRCRAFT, AIRLINES
RU - RUN, RULE, RUNS, RULES, RURAL, RUSSIA, RUBBER, RUNNING, RUSSIAN, RUSSELL
PL - PLAN, PLAY, PLUS, PLACE, PLANS, PLANT, PLEASE, PLAYER, PLAYERS, PLANNING
RA - RATE, RATES, RANGE, RADIO, EXTRA, RATED, RATING, CAMERA, RATHER, RATINGS
EW - NEW, FEW, VIEW, KNEW, CREW, REVIEW, ANDREW, PREVIEW, OVERVIEW, INTERVIEW
BE - BEEN, BEST, BEING, BELOW, BEACH, BEFORE, BETTER, BECOME, BECAUSE, BETWEEN
PO - POST, PORN, POWER, POSTS, POINT, POKER, POLICY, POSTED, POPULAR, POSSIBLE
TE - SITE, DATE, TEXT, RATE, STATE, TERMS, WHITE, WEBSITE, PRIVATE, TECHNOLOGY
FL - FLAT, FLOW, FLAG, FLASH, FLOOR, FLIGHT, FLOWER, FLORIDA, FLOWERS, FLIGHTS
KN - KNOW, KNEW, KNEE, KNOWN, KNOWS, KNIFE, KNIGHT, KNIVES, KNOWING, KNOWLEDGE
RD - CARD, HARD, WORD, BOARD, THIRD, AWARD, RECORD, FORWARD, STANDARD, PASSWORD
EC - DEC, SEC, NEC, ECHO, SPEC, QUEBEC, ECONOMY, ECONOMIC, ECONOMICS, ECOMMERCE
DY - BODY, LADY, ANDY, STUDY, READY, BUDDY, COMEDY, ALREADY, DYNAMIC, EVERYBODY
LU - FLU, LUCK, LUNG, LUKE, LUNCH, LUCKY, LUXURY, LUGGAGE, HONOLULU, LUXEMBOURG
CL - CLUB, CLICK, CLASS, CLOSE, CLEAR, CLEAN, CLIENT, CLASSIC, CLASSES, CLOTHING
OD - GOD, GOOD, FOOD, WOOD, IPOD, BLOOD, PERIOD, METHOD, HOLLYWOOD, NEIGHBORHOOD
JA - JAN, JAVA, JACK, JAZZ, JAMES, JAPAN, JANUARY, JACKSON, JAPANESE, JAVASCRIPT
LY - ONLY, JULY, REPLY, DAILY, EARLY, FAMILY, REALLY, LYRICS, USUALLY, CURRENTLY
AD - HAD, ADD, READ, ROAD, ADDED, THREAD, ADDRESS, DOWNLOAD, ADVANCED, ADDITIONAL
GR - GROUP, GREAT, GREEN, GRAND, GRADE, GROUPS, GROWTH, GROUND, GREATER, GRAPHICS
JE - JET, JEFF, JEAN, JESUS, JERSEY, JEWISH, JEWELRY, JESSICA, JENNIFER, JEWELLERY
BR - BRAND, BROWN, BRING, BREAK, BROWSE, BRANDS, BREAST, BRITISH, BROWSER, BROUGHT
UM - CUM, ZUM, FORUM, ALBUM, MEDIUM, MUSEUM, MAXIMUM, MINIMUM, PREMIUM, CURRICULUM
HS - VHS, NHS, PATHS, HIGHS, BATHS, MONTHS, DEATHS, GRAPHS, STRENGTHS, PHOTOGRAPHS
SY - EASY, BUSY, PUSSY, SYSTEM, SYDNEY, SYMBOL, SYNTAX, SYSTEMS, FANTASY, SYMPTOMS
GL - GLAD, GLASS, GLOBE, GLORY, GLOBAL, GLANCE, GLOVES, GLASSES, GLASGOW, GLOSSARY
OK - BOOK, LOOK, TOOK, COOK, OKAY, OUTLOOK, OKLAHOMA, NOTEBOOK, HANDBOOK, GUESTBOOK
OU - YOU, OUR, OUT, OUTPUT, OUTLET, OUTSIDE, OUTDOOR, OUTLOOK, OUTDOORS, OUTSTANDING
OF - OFF, OFFER, OFTEN, OFFICE, OFFERS, OFFERED, OFFICER, OFFICES, OFFICIAL, OFFERING
AM - TEAM, AMONG, AMOUNT, AMAZON, STREAM, PROGRAM, AMERICA, WILLIAM, AMATEUR, AMERICAN
OV - NOV, OVER, OVEN, OVAL, OVERALL, OVERVIEW, OVERSEAS, OVERCOME, OVERHEAD, OVERNIGHT
GU - GUY, GUYS, GUIDE, GUEST, GUESS, GUIDES, GUITAR, GUARANTEE, GUIDELINES, GUARANTEED
OR - FOR, ORDER, MAJOR, COLOR, ERROR, AUTHOR, ORDERS, ORIGINAL, DIRECTOR, ORGANIZATION
PT - KEPT, EGYPT, ADOPT, EXCEPT, ACCEPT, SCRIPT, CONCEPT, ATTEMPT, RECEIPT, JAVASCRIPT
GS - TAGS, SONGS, BLOGS, DRUGS, THINGS, RATINGS, SAVINGS, LISTINGS, SETTINGS, MEETINGS
ED - USED, NEED, BASED, UNITED, POSTED, RELATED, RESERVED, ADVANCED, PROVIDED, EDUCATION
SP - SPACE, SPEED, SPORT, SPAIN, SPORTS, SPRING, SPECIAL, SPECIFIC, SPONSORED, SPECIFIED
EM - THEM, ITEM, SEEM, EMAIL, SYSTEM, PROBLEM, EMPLOYEE, EMPLOYEES, EMERGENCY, EMPLOYMENT
ZE - SIZE, ZERO, PRIZE, BRONZE, ZEALAND, REALIZE, ANALYZE, ORGANIZE, RECOGNIZE, CUSTOMIZE
CR - CROSS, CRIME, CREEK, CREDIT, CREATE, CREATED, CREATIVE, CRITICAL, CREATING, CRIMINAL
PH - PHP, PHONE, PHOTO, PHASE, PHOTOS, PHONES, JOSEPH, PHYSICAL, PHOTOGRAPHY, PHENTERMINE
SC - SCORE, SCALE, SCOTT, SCHOOL, SCREEN, SCIENCE, SCHOOLS, SCHEDULE, SCIENCES, SCIENTIFIC
NG - LONG, USING, BEING, RATING, DURING, LISTING, SHIPPING, SHOPPING, FOLLOWING, INCLUDING
OB - JOB, BOB, OBJECT, OBTAIN, OBJECTS, BLOWJOB, OBTAINED, OBSERVED, OBJECTIVE, OBJECTIVES
UL - JUL, PAUL, SOUL, USEFUL, HELPFUL, POWERFUL, ULTIMATE, BEAUTIFUL, WONDERFUL, SUCCESSFUL
TY - CITY, TYPE, PARTY, COUNTY, QUALITY, SOCIETY, SECURITY, PROPERTY, COMMUNITY, UNIVERSITY
IM - HIM, JIM, IMAGE, CLAIM, IMAGES, IMPACT, IMPROVE, IMPORTANT, IMMEDIATELY, IMPLEMENTATION
RY - VERY, EVERY, JANUARY, HISTORY, COUNTRY, GALLERY, LIBRARY, CATEGORY, INDUSTRY, DIRECTORY
IC - MUSIC, TOPIC, BASIC, PUBLIC, CLASSIC, TRAFFIC, SPECIFIC, ECONOMIC, REPUBLIC, ELECTRONIC
CO - CODE, COULD, COUNTY, CONTACT, COMPANY, CONTROL, COMMENTS, COMPUTER, COPYRIGHT, COMMUNITY
PR - PRICE, PRICES, PRODUCT, PRIVACY, PROGRAM, PROJECT, PROFILE, PRODUCTS, PREVIOUS, PROPERTY
IN - INTO, INFO, MAIN, INDEX, WITHIN, INTERNET, INCLUDING, INSURANCE, INFORMATION, INTERNATIONAL
NS - MEANS, LOANS, PLANS, TEENS, OPTIONS, RETURNS, QUESTIONS, SOLUTIONS, CONDITIONS, APPLICATIONS
CY - CYCLE, POLICY, AGENCY, PRIVACY, CURRENCY, ACCURACY, PHARMACY, EMERGENCY, FREQUENCY, PREGNANCY
HY - WHY, THY, HYBRID, MURPHY, HEALTHY, BIOGRAPHY, GEOGRAPHY, PHILOSOPHY, PHOTOGRAPHY, BIBLIOGRAPHY
AF - AFTER, AFRICA, AFFECT, AFRICAN, AFFAIRS, AFFECTED, AFFILIATE, AFTERNOON, AFFILIATES, AFFORDABLE
PU - PUT, PUSSY, PUBLIC, PURPOSE, PURCHASE, PURPOSES, PUBLISHED, PUBLISHER, PUBLICATION, PUBLICATIONS
EQ - EQUAL, EQUITY, EQUALLY, EQUATION, EQUIPPED, EQUALITY, EQUIPMENT, EQUATIONS, EQUIVALENT, EQUILIBRIUM
GY - GYM, ORGY, ENERGY, BIOLOGY, STRATEGY, GENEALOGY, TECHNOLOGY, PSYCHOLOGY, METHODOLOGY, BIOTECHNOLOGY
IR - AIR, AIR, SIR, DIR, IRC, IRS, CIR, IRA, HAIR, IRAQ, FAIR, IRON, PAIR, HAIR, IRAQ, FAIR, IRON, PAIR, IRAN, THEIR, CHAIR, THEIR, CHAIR, IRISH, IRAQI, BLAIR, CHOIR, REPAIR, REPAIR, AFFAIR, IRELAND, IRELAND, RESERVOIR, IRRIGATION
SL - DSL, DSL, SSL, SLOW, SLOT, SLIP, SLOW, SLOT, SLIP, SLIM, SLUT, ADSL, SLEEP, SLIDE, SLOTS, SLEEP, SLIDE, SLOTS, SLAVE, SLUTS, SLOPE, SLOWLY, SLOWLY, SLEEVE, SLIGHT, SLIDES, SLOVAK, SLEEPS, SLIGHTLY, SLEEPING, SLIGHTLY, SLEEPING, SLOVENIA, SLOVAKIA, SLIDESHOW
OT - NOT, HOT, GOT, LOT, NOT, HOT, GOT, LOT, DOT, POT, ROOT, SHOT, FOOT, ROOT, SHOT, FOOT, SPOT, SLOT, BOOT, PLOT, PROT, ALOT, OTHER, OTHER, PILOT, SHOOT, ROBOT, DEPOT, OTHERS, OTHERS, FORGOT, OTTAWA, BALLOT, CUMSHOT, GAMESPOT, SNAPSHOT, OTHERWISE, OTHERWISE, SCREENSHOT
OM - COM, TOM, COM, TOM, MOM, ROM, DOM, FROM, ROOM, ATOM, FROM, ROOM, ATOM, ZOOM, WHOM, BOOM, OMAN, DOOM, OMEGA, OMAHA, BLOOM, CUSTOM, BOTTOM, RANDOM, CUSTOM, BOTTOM, RANDOM, WISDOM, KINGDOM, FREEDOM, KINGDOM, FREEDOM, BEDROOM, TELECOM, PHANTOM, BATHROOM, CLASSROOM, OMISSIONS
SM - SMS, GSM, BDSM, SMTP, SMALL, SMITH, SMART, SMOKE, SMALL, SMITH, SMART, SMOKE, SMILE, SMELL, SMOOTH, SMOOTH, ORGASM, TOURISM, SMOKING, SMALLER, TOURISM, SMOKING, SMALLER, SMILIES, SMALLEST, MECHANISM, TERRORISM, MECHANISM, TERRORISM, CRITICISM, METABOLISM, JOURNALISM, SMITHSONIAN
OC - OCT, DOC, OCT, DOC, LOC, SOC, BOC, OCLC, PROC, OCEAN, OCCUR, OCEAN, OCCUR, OCCURS, OCCURS, OCTOBER, OCTOBER, OCCURRED, OCCASION, OCCURRED, OCCASION, OCCUPIED, OCCASIONS, OCCURRING, OCCUPATION, OCCUPATION, OCCASIONAL, OCCURRENCE, OCCUPATIONS, OCCUPATIONAL, OCCUPATIONAL, OCCASIONALLY
KI - KIT, SKI, KIT, SKI, KID, KIM, KIDS, KING, KIND, KILL, KITS, KIDS, KING, KIND, KILL, KITS, WIKI, KISS, KICK, KIRK, KINDS, KINDS, KINGS, TWIKI, KILLS, KITTY, KINDA, KILLED, KILLER, KIJIJI, SUZUKI, KIDNEY, KINASE, KINGDOM, KITCHEN, KINGDOM, KITCHEN, KILLING, KISSING, KINGSTON, MEDIAWIKI, KILOMETERS
HU - THU, THU, HUB, HUGE, HUGE, HUNT, HURT, HUNG, HULL, HUGH, HUGO, HUMAN, HUMOR, HUMAN, HUMOR, HUNTER, HUNTER, HUMANS, HUDSON, HUGHES, HUNGRY, HUNGER, HUSBAND, HUNTING, HUNDRED, HUSBAND, HUNTING, HUNDRED, HUNGARY, HUNDREDS, HUNDREDS, HUMIDITY, HUMANITY, HURRICANE, HURRICANE, HUNGARIAN, HUMANITIES, HUNTINGTON, HUMANITARIAN
OW - NOW, HOW, OWN, LOW, NOW, HOW, OWN, LOW, ROW, WOW, BOW, COW, DOW, KNOW, SHOW, KNOW, SHOW, FLOW, SNOW, BLOW, SLOW, GROW, OWEN, OWNS, GLOW, BELOW, BELOW, ALLOW, OWNER, OWNED, THROW, ARROW, WINDOW, YELLOW, FOLLOW, WINDOW, YELLOW, FOLLOW, OWNERS, NARROW, FELLOW, SHADOW, MOSCOW, PILLOW, HOLLOW, WILLOW, GLASGOW, RAINBOW, SOMEHOW, TOMORROW, WORKFLOW, OWNERSHIP, SLIDESHOW
ID - DID, BID, AID, MID, DID, BID, AID, MID, KID, VID, IDE, RID, LID, IDS, SAID, IDEA, PAID, SAID, IDEA, PAID, VOID, ACID, GRID, PMID, LAID, RAID, IDLE, REID, IDOL, DAVID, IDEAS, VALID, DAVID, IDEAS, VALID, SOLID, AVOID, IDEAL, IDAHO, RAPID, FLUID, MSGID, LIQUID, STUPID, HYBRID, AFRAID, MADRID, INVALID, PREPAID, IDENTIFY, IDENTITY, MEDICAID, IDENTICAL, IDENTIFIED, IDENTIFIER, IDENTIFIES, IDENTIFYING, IDENTIFICATION
FE - FEW, FEB, FEW, FEB, FEE, FED, LIFE, FEEL, LIFE, FEEL, SAFE, FEED, FEET, FEES, WIFE, FELT, FEAR, CAFE, FELL, FEOF, FEAT, FEEDS, FEELS, KNIFE, FEWER, FERRY, FEVER, FENCE, FEARS, FEMALE, FEMALE, FETISH, FELLOW, FEDERAL, FEDERAL, FEATURE, FEELING, FEEDING, FEMALES, FERRARI, FEATURES, FEEDBACK, FEBRUARY, FEATURED, FEATURES, FEEDBACK, FEBRUARY, FEATURED, FESTIVAL, WILDLIFE, FEELINGS, FEATURING, FESTIVALS, NIGHTLIFE, FEDERATION, FELLOWSHIP
VA - VAN, VAN, VAR, VAT, VAL, EVA, JAVA, JAVA, VARY, NOVA, VAST, VALUE, VALID, VALUE, VALID, VALVE, VAULT, VALUES, VALLEY, VALUES, VALLEY, VACUUM, GENEVA, VALIUM, VARIED, VALUED, VARIES, VAGINA, VALVES, VARIOUS, VARIETY, VARIOUS, VARIETY, VACCINE, VARYING, VAMPIRE, VATICAN, VANILLA, MOLDOVA, VACATION, VARIABLE, VACATION, VARIABLE, VALUABLE, VALIDITY, VARIANCE, VARIABLES, VANCOUVER, VACATIONS, VALENTINE, VARIATION, VALUATION, VACANCIES, VARIETIES, VARIATIONS, VALIDATION
KE - KEY, KEY, KEN, LIKE, MAKE, TAKE, KEEP, LAKE, MIKE, LIKE, MAKE, TAKE, KEEP, LAKE, MIKE, KEPT, BIKE, KEYS, CAKE, KENT, WAKE, DUKE, NIKE, FAKE, LUKE, JOKE, NUKE, SAKE, JAKE, KEEN, KENO, PIKE, KELLY, KELLY, KEVIN, SMOKE, DICKE, KERRY, KEITH, KEEPS, KENYA, SPOKE, BROKE, BRAKE, SNAKE, SHAKE, ALIKE, KENNY, BURKE, BLAKE, STAKE, KERNEL, STRIKE, UNLIKE, STROKE, INTAKE, KELKOO, CLARKE, KEYWORD, KEYWORD, KEEPING, BUKKAKE, KENNEDY, MISTAKE, KENNETH, KARAOKE, KEYWORDS, KEYWORDS, KENTUCKY, KEYBOARD, KEYBOARDS, UNDERTAKE, EARTHQUAKE
ET - GET, SET, LET, YET, NET, GET, SET, LET, YET, NET, ETC, PET, MET, WET, JET, BET, CET, MEET, CNET, MEET, CNET, FEET, DIET, POET, SHEET, SWEET, ASSET, QUIET, ZDNET, FLEET, RESET, JANET, VSNET, UPSET, MARKET, STREET, MARKET, STREET, BUDGET, TARGET, BASKET, POCKET, SECRET, TICKET, PLANET, FORGET, OUTLET, ETHICS, JACKET, ETHNIC, PACKET, SOCKET, OFFSET, CARPET, INKJET, SUNSET, TABLET, TOILET, SOVIET, ROCKET, BULLET, MAGNET, HELMET, WALLET, BALLET, VELVET, GOURMET, CABINET, CRICKET, HEADSET, ETHICAL, ETERNAL, BLANKET, PROPHET, BRACKET, BOUQUET, INTERNET, INTERNET, ETHERNET, MARGARET, BRACELET, ETHIOPIA, SOMERSET, FIORICET, INTRANET, CHEVROLET
NA - DNA, NAV, RNA, NAT, NAM, UNA, ANA, NAME, NAME, NAVY, NASA, ANNA, NAIL, NANO, DANA, NATO, MRNA, CDNA, CHINA, NAMES, NAKED, CHINA, NAMES, NAKED, NAMED, ARENA, GONNA, NANCY, WANNA, NAVAL, DONNA, GHANA, NASTY, DIANA, NAILS, NATURE, NATION, NATURE, NATION, NATIVE, LATINA, NARROW, NASCAR, VIENNA, MARINA, NASDAQ, HELENA, NAMELY, NATHAN, VAGINA, GUYANA, BANANA, NAPLES, NATURAL, NATURAL, ARIZONA, INDIANA, NATIONS, MONTANA, ANTENNA, KATRINA, MADONNA, NAMIBIA, NAUGHTY, NIRVANA, NATIONAL, CAROLINA, NATIONAL, CAROLINA, NAVIGATE, BOTSWANA, NATURALS, LOUISIANA, ARGENTINA, NASHVILLE, NATURALLY, BARCELONA, CHRISTINA, NARRATIVE, NAVIGATOR, MARIJUANA, NAMESPACE, NAVIGATION, NAVIGATION, NATIONWIDE, NATIONALLY
AC - ACT, ACT, MAC, ACC, ACE, PAC, ACM, ACID, ACTS, ACER, ACRE, ACNE, ACTOR, ACRES, ACUTE, ACIDS, ISAAC, ACCESS, ACTION, ACTIVE, ACROSS, ACCESS, ACTION, ACTIVE, ACROSS, ACCEPT, ACTUAL, ACTING, ACTORS, ACCENT, PROZAC, ACCOUNT, ACCOUNT, ACTIONS, ACADEMY, ACHIEVE, ACROBAT, ACQUIRE, ACCUSED, ACTRESS, ACCEPTS, PONTIAC, ACRYLIC, CARDIAC, ACTIVITY, ACTIVITY, ACTUALLY, ACADEMIC, ACCEPTED, ACCOUNTS, ACCURACY, ACCURATE, ACCIDENT, ACHIEVED, ACQUIRED, ACOUSTIC, ACCESSED, ACTIVELY, CADILLAC, ACCORDING, ACCORDING, ACCESSORY, ACCIDENTS, ACHIEVING, ACCESSING, ACTIVATED, ACCEPTING, ACADEMICS, ACTIVISTS, ACTIVITIES, ACTIVITIES, ACCOUNTING, ACCEPTANCE, ACCORDANCE, ACCESSIBLE, ACCEPTABLE, ACTIVATION, ACCREDITED, ACCURATELY, ACDBENTITY, ACCOMPLISH, ACCESSORIES, ACCESSORIES, ACQUISITION, ACHIEVEMENT, ACCORDINGLY, ACCOMPANIED, ACCOMMODATE, ACKNOWLEDGE, ACCOMPLISHED, ACKNOWLEDGED, ACCOMPANYING, ACHIEVEMENTS, ACQUISITIONS, ACCOMMODATION, ACCESSIBILITY, ACCREDITATION, ACCOMMODATIONS, ACCOUNTABILITY
VE - AVE, EVE, VER, HAVE, VERY, LOVE, SAVE, LIVE, GIVE, HAVE, VERY, LOVE, SAVE, LIVE, GIVE, FIVE, MOVE, GAVE, DAVE, WAVE, DIVE, CAVE, COVE, ABOVE, DRIVE, ABOVE, DRIVE, LEAVE, VEGAS, STEVE, SERVE, ALIVE, PROVE, GROVE, VENUE, SOLVE, VALVE, CURVE, SLAVE, OLIVE, VERSE, GRAVE, NERVE, VERDE, DROVE, BRAVE, ACTIVE, REMOVE, NATIVE, VENDOR, VECTOR, VERIFY, VERSUS, ARRIVE, SLEEVE, TWELVE, VENUES, VENICE, VESSEL, VERNON, VERTEX, VELVET, GROOVE, VERBAL, VERSION, ARCHIVE, VERSION, ARCHIVE, RECEIVE, BELIEVE, IMPROVE, VEHICLE, RESERVE, ACHIEVE, VERMONT, MASSIVE, VENTURE, VENDORS, INVOLVE, RESOLVE, APPROVE, VERIZON, VETERAN, SURVIVE, VESSELS, OBSERVE, DESERVE, PASSIVE, POSITIVE, CREATIVE, VEHICLES, NEGATIVE, RELATIVE, VERSIONS, VERTICAL, VETERANS, VERIFIED, VELOCITY, PRESERVE, RETRIEVE, ADAPTIVE, VENTURES, EFFECTIVE, EXECUTIVE, EXCLUSIVE, OBJECTIVE, EXTENSIVE, SENSITIVE, EXPENSIVE, VENEZUELA, INCLUSIVE, INTENSIVE, OFFENSIVE, DIRECTIVE, MICROWAVE, COGNITIVE, INCENTIVE, VEGETABLE, EXCESSIVE, NARRATIVE, SELECTIVE, DEFENSIVE, DETECTIVE, RESPECTIVE, AUTOMOTIVE, INITIATIVE, INNOVATIVE, COLLECTIVE, ATTRACTIVE, PROTECTIVE, VEGETABLES, IMPRESSIVE, DECORATIVE, VETERINARY, AGGRESSIVE, PRODUCTIVE, CUMULATIVE, VEGETARIAN, VEGETATION, SUBJECTIVE, ALTERNATIVE, INTERACTIVE, COMPETITIVE, VERZEICHNIS, PERSPECTIVE, LEGISLATIVE, PROGRESSIVE, COOPERATIVE, PROSPECTIVE, COMPARATIVE, CONSECUTIVE, INFORMATIVE, INEXPENSIVE, CONSERVATIVE, VERIFICATION, QUANTITATIVE, REPRODUCTIVE, COMPREHENSIVE, COLLABORATIVE, ADMINISTRATIVE, REPRESENTATIVE
CE - ICE, CEO, ACE, CET, CELL, ONCE, FACE, NICE, RACE, VICE, CENT, RICE, PACE, MICE, LACE, DICE, PRICE, PLACE, SINCE, PRICE, PLACE, SINCE, SPACE, FORCE, VOICE, DANCE, PEACE, PIECE, CELLS, BRUCE, TWICE, GRACE, HENCE, ALICE, TRACE, JUICE, SAUCE, CENTS, CEDAR, SPICE, FENCE, LANCE, JOYCE, CENTER, OFFICE, SOURCE, CENTER, OFFICE, SOURCE, NOTICE, FRANCE, CENTRE, ADVICE, CHOICE, POLICE, DEVICE, CHANCE, REDUCE, CENSUS, PRINCE, GREECE, GLANCE, PALACE, VENICE, CELTIC, TRANCE, CELEBS, FLEECE, PIERCE, CEMENT, SERVICE, SCIENCE, SERVICE, SCIENCE, CENTRAL, FINANCE, CERTAIN, CENTURY, SURFACE, JUSTICE, ADVANCE, BALANCE, CENTERS, PRODUCE, REPLACE, ENHANCE, ROMANCE, ABSENCE, CENTRES, DIVORCE, DEFENCE, LICENCE, CEILING, CERAMIC, SILENCE, WALLACE, MYSPACE, INVOICE, TERRACE, ESSENCE, RESOURCE, PRACTICE, EVIDENCE, DISTANCE, COMMERCE, SEQUENCE, VIOLENCE, PRESENCE, INSTANCE, AUDIENCE, GUIDANCE, ALLIANCE, PROVINCE, CELLULAR, LAWRENCE, SENTENCE, ENTRANCE, ANNOUNCE, CEMETERY, FLORENCE, NECKLACE, CEREMONY, RELIANCE, CENTERED, VARIANCE, INSURANCE, INSURANCE, REFERENCE, INTERFACE, CERTIFIED, CERTAINLY, INFLUENCE, CELEBRITY, CLEARANCE, RESIDENCE, SUBSTANCE, EXISTENCE, WORKPLACE, INTRODUCE, ASSURANCE, REFINANCE, WORKFORCE, ECOMMERCE, CELEBRATE, APPLIANCE, ORDINANCE, RELEVANCE, FRAGRANCE, TOLERANCE, FREELANCE, AEROSPACE, CENTURIES, INCIDENCE, LISTPRICE, ALLOWANCE, SACRIFICE, NAMESPACE, FIREPLACE, REPRODUCE, EXPERIENCE, CONFERENCE, ASSISTANCE, DIFFERENCE, COMPLIANCE, ACCEPTANCE, IMPORTANCE, ACCORDANCE, CONFIDENCE, RESISTANCE, APPEARANCE, EXCELLENCE, ATTENDANCE, GOVERNANCE, PREFERENCE, PROVIDENCE, DEPENDENCE, OCCURRENCE, PERFORMANCE, PERFORMANCE, MAINTENANCE, CERTIFICATE, MARKETPLACE, CONVENIENCE, CELEBRITIES, CELEBRATION, RENAISSANCE, CONSEQUENCE, CONVERGENCE, MALPRACTICE, EVANESCENCE, INTELLIGENCE, CERTIFICATES, INDEPENDENCE, SURVEILLANCE, SIGNIFICANCE, INTERFERENCE, CERTIFICATION, CORRESPONDENCE
LE - LET, LED, LEE, LES, LEG, LEO, LEN, LEU, FILE, FILE, SALE, LEFT, LESS, ABLE, ROLE, LEAD, MALE, RULE, HOLE, LENS, LEGS, MILE, LETS, SOLE, LEAF, COLE, TALE, ISLE, DALE, POLE, TILE, LEAN, YALE, LEON, IDLE, LEVY, KYLE, PALE, GALE, WHILE, LEVEL, TITLE, LEARN, WHILE, LEVEL, TITLE, LEARN, TABLE, LEGAL, LEAST, STYLE, WHOLE, LEAVE, CABLE, APPLE, SCALE, BIBLE, LEADS, CYCLE, LEWIS, LEASE, ANGLE, EAGLE, CHILE, SMILE, NOBLE, MAPLE, LEEDS, LEMON, UNCLE, LEONE, LEXUS, WHALE, BELLE, PEOPLE, LITTLE, PEOPLE, LITTLE, MOBILE, SINGLE, SIMPLE, GOOGLE, DOUBLE, MIDDLE, LENGTH, SAMPLE, LEVELS, LETTER, FEMALE, MODULE, COUPLE, LEAGUE, ENABLE, LEADER, HANDLE, BATTLE, CIRCLE, LEAVES, MUSCLE, UNABLE, CASTLE, STABLE, LESSON, BOTTLE, LEGEND, ORACLE, TEMPLE, PURPLE, PUZZLE, LEGACY, TRIPLE, LENSES, LIABLE, CANDLE, BUBBLE, CATTLE, NICOLE, NIPPLE, LOCALE, BUNDLE, JUNGLE, ANDALE, LENDER, GENTLE, MARBLE, TACKLE, LESLIE, SETTLE, LESSER, NEEDLE, TURTLE, SUBTLE, CRADLE, MYRTLE, PROFILE, ARTICLE, PROFILE, ARTICLE, EXAMPLE, LESBIAN, LEADING, VEHICLE, LEATHER, LETTERS, LEADERS, SEATTLE, SHEMALE, TROUBLE, LEAVING, LEISURE, LEARNED, LESSONS, CONSOLE, CAPABLE, LECTURE, VISIBLE, LEBANON, PAYABLE, LEASING, LEVITRA, COMPILE, SHUTTLE, BICYCLE, LETTING, LEGENDS, DISABLE, LEONARD, LENDING, DURABLE, LENDERS, LEXMARK, LEGALLY, TEXTILE, MIRACLE, MISSILE, POSSIBLE, LEARNING, MULTIPLE, SCHEDULE, VARIABLE, PORTABLE, ELIGIBLE, LESBIANS, SUITABLE, RELIABLE, FLEXIBLE, VALUABLE, MICHELLE, JUVENILE, STRUGGLE, LECTURES, TERRIBLE, PARTICLE, TRIANGLE, HORRIBLE, ENSEMBLE, LEARNERS, AVAILABLE, AVAILABLE, WHOLESALE, PRINTABLE, LIFESTYLE, PRINCIPLE, NASHVILLE, NEWCASTLE, MEANWHILE, VEGETABLE, CHRONICLE, INVISIBLE, LEXINGTON, RENEWABLE, DESIRABLE, REMOVABLE, LEGENDARY, LEADERSHIP, APPLICABLE, COMPATIBLE, REASONABLE, AFFORDABLE, ACCESSIBLE, IMPOSSIBLE, MOTORCYCLE, ACCEPTABLE, ADJUSTABLE, INCREDIBLE, AUTOMOBILE, LOUISVILLE, COMPARABLE, VULNERABLE, REMARKABLE, LEGITIMATE, LAUDERDALE, CHARITABLE, RESPONSIBLE, LEGISLATION, COMFORTABLE, LEGISLATIVE, SUSTAINABLE, LEGISLATURE, UNAVAILABLE, CONVERTIBLE, COLLECTIBLE, JACKSONVILLE, CONSIDERABLE, DOWNLOADABLE
ST - EST, PST, CST, STD, IST, STE, STR, GST, LIST, JUST, LAST, MOST, POST, BEST, MUST, LIST, JUST, LAST, MOST, POST, BEST, MUST, WEST, COST, TEST, EAST, STAR, PAST, FAST, STEP, STAY, STOP, LOST, REST, HOST, CAST, HIST, DUST, VAST, STEM, STUD, STAT, DIST, FIST, PEST, NEST, STAN, FIRST, STATE, STORE, FIRST, STATE, STORE, STILL, STOCK, START, STUDY, STAFF, STORY, LEAST, STYLE, STUFF, STARS, GUEST, TRUST, STAGE, STEEL, COAST, STAND, STONE, STEVE, STEPS, STATS, EXIST, STICK, STORM, CONST, STRIP, WORST, BEAST, GHOST, QUEST, BOOST, CHEST, STRAP, STEAM, STOOD, STACK, STAMP, BLAST, STUCK, STOPS, TWIST, STEAL, WRIST, YEAST, FROST, STAYS, CREST, BURST, STAKE, STATES, STREET, STORES, AUGUST, LATEST, STATUS, ARTIST, ALMOST, STRONG, STRING, INCEST, STUDIO, FOREST, LOWEST, BREAST, STREAM, STATED, ASSIST, STATIC, CHRIST, STRESS, NEWEST, STYLES, STARTS, STOCKS, STANDS, STRIKE, STORED, STABLE, STEREO, STAMPS, OLDEST, STEVEN, DIGEST, STUPID, STAGES, STONES, STRUCT, STROKE, HONEST, STAYED, INVEST, FINEST, WHILST, STRAIN, ADJUST, STUART, STYLUS, STRUCK, STRICT, STEADY, ARREST, PRIEST, STOLEN, ROBUST, NUDIST, STICKS, STRAND, STRIPS, STICKY, RESIST, AGAINST, STUDENT, REQUEST, STORIES, STUDIES, STORAGE, STARTED, STATION, HIGHEST, LARGEST, SUGGEST, STEPHEN, CONTEST, BIGGEST, STRANGE, ANALYST, STREETS, STUDIOS, TOURIST, STOPPED, NEAREST, STEWART, STUDIED, FLORIST, STRINGS, PODCAST, STRETCH, STADIUM, STANLEY, STARTER, STYLISH, HARVEST, STATUTE, STAYING, STREAMS, BAPTIST, HOTTEST, STEVENS, FASTEST, PROTEST, STARTUP, EXHAUST, AMONGST, MIDWEST, SOONEST, STOMACH, CLOSEST, CONSIST, STICKER, STRIKES, BELFAST, LONGEST, STATING, WEBCAST, STRIPES, STUFFED, STUDENTS, STANDARD, INTEREST, STARTING, STRATEGY, STRAIGHT, FORECAST, STRENGTH, STANDING, STATIONS, GREATEST, STERLING, CONTRAST, STRONGLY, WISHLIST, STEERING, STRUGGLE, STARRING, STRICTLY, STUDYING, STRONGER, STANFORD, CHEAPEST, STICKERS, STUNNING, STAFFING, PLAYLIST, STATUTES, STOPPING, CATALYST, STRIKING, STRANGER, EARLIEST, BUDAPEST, SMALLEST, STATEMENT, STANDARDS, STRUCTURE, BREAKFAST, STRATEGIC, NORTHWEST, BROADCAST, STAINLESS, STABILITY, SOUTHWEST, SOUTHEAST, STATUTORY, NORTHEAST, TERRORIST, STREAMING, STOCKINGS, SCIENTIST, STATEWIDE, STRENGTHS, STANDINGS, CHECKLIST, STEPHANIE, HOLOCAUST, COMMUNIST, STOCKHOLM, THERAPIST, STATISTICS, STRATEGIES, STATEMENTS, STRUCTURES, SPECIALIST, STRUCTURAL, STRUCTURED, STRENGTHEN, STATIONERY, JOURNALIST, STATISTICAL, STAKEHOLDERS, STARSMERCHANT, STRENGTHENING
AL - ALL, ALL, CAL, VAL, PAL, ALT, ALI, WAL, ALA, ALSO, REAL, ALSO, REAL, DEAL, ANAL, GOAL, ORAL, DUAL, ALAN, ALEX, DIAL, SEAL, MEAL, COAL, OVAL, ALTO, EVAL, ALOT, LOCAL, TOTAL, LOCAL, TOTAL, LEGAL, FINAL, ALONG, ALBUM, ALLOW, TRIAL, METAL, ROYAL, ALONE, EQUAL, ALERT, RURAL, ALPHA, IDEAL, ALLEN, ALARM, USUAL, ALIVE, VITAL, MORAL, ALICE, ALIEN, NEPAL, VOCAL, CORAL, CANAL, NAVAL, ALTER, MEDAL, ALIAS, FATAL, STEAL, ALIKE, VIRAL, ALLAN, FOCAL, ALIGN, ALLOY, ALLAH, SOCIAL, ALWAYS, GLOBAL, ANNUAL, RENTAL, ALMOST, ANIMAL, PAYPAL, NORMAL, ALLOWS, VISUAL, MANUAL, ACTUAL, MENTAL, SIGNAL, SEXUAL, ALASKA, PORTAL, POSTAL, APPEAL, SERIAL, ALBUMS, FISCAL, DENTAL, ALERTS, FORMAL, ALUMNI, MUTUAL, CASUAL, ALBERT, FACIAL, ALBANY, FLORAL, HERBAL, BRIDAL, TRIBAL, REVEAL, ALFRED, RACIAL, ALLIED, ALPINE, AERIAL, DENIAL, BRUTAL, NEURAL, VERBAL, GENERAL, SPECIAL, GENERAL, SPECIAL, DIGITAL, MEDICAL, JOURNAL, CENTRAL, ALREADY, SEVERAL, NATURAL, FEDERAL, CAPITAL, VIRTUAL, MUSICAL, ALLOWED, INITIAL, CRYSTAL, ALABAMA, REMOVAL, OPTICAL, ALCOHOL, ILLEGAL, TYPICAL, LIBERAL, ALBERTA, ARRIVAL, PARTIAL, THERMAL, COASTAL, FUNERAL, UNUSUAL, MINIMAL, LOGICAL, MINERAL, ETHICAL, NEUTRAL, OPTIMAL, RENEWAL, CRUCIAL, SPATIAL, MARTIAL, RADICAL, ALLEGED, ETERNAL, ALGEBRA, ALBANIA, ALLERGY, ALGERIA, ALTERED, SENEGAL, DECIMAL, MAGICAL, NATIONAL, PERSONAL, NATIONAL, PERSONAL, ORIGINAL, OFFICIAL, MATERIAL, ALTHOUGH, REGIONAL, PHYSICAL, HOSPITAL, INTERNAL, EXTERNAL, CRITICAL, CLINICAL, CULTURAL, OPTIONAL, CHEMICAL, APPROVAL, CRIMINAL, FESTIVAL, PROPOSAL, ALLIANCE, TERMINAL, MEMORIAL, ALLOWING, TUTORIAL, PORTUGAL, VERTICAL, TROPICAL, SURVIVAL, ALUMINUM, JUDICIAL, MONTREAL, DISPOSAL, SEASONAL, REFERRAL, INTERVAL, SURGICAL, IMPERIAL, INTEGRAL, INFORMAL, MEDIEVAL, ORIENTAL, COLONIAL, RATIONAL, CARNIVAL, PARENTAL, BIBLICAL, TRIBUNAL, TEMPORAL, FINANCIAL, TECHNICAL, POLITICAL, POTENTIAL, ESSENTIAL, UNIVERSAL, CLASSICAL, EDITORIAL, PRACTICAL, PRINCIPAL, SPIRITUAL, ALEXANDER, ALGORITHM, ALLOCATED, MUNICIPAL, EMOTIONAL, ALTERNATE, IDENTICAL, NUMERICAL, ALIGNMENT, APPRAISAL, GRAPHICAL, ALLOWANCE, RETRIEVAL, EMPIRICAL, CATHEDRAL, BACTERIAL, ELECTORAL, ALUMINIUM, ADDITIONAL, INDIVIDUAL, COMMERCIAL, INDUSTRIAL, HISTORICAL, FUNCTIONAL, ELECTRICAL, BIOLOGICAL, MECHANICAL, STRUCTURAL, ALLOCATION, HORIZONTAL, ARTIFICIAL, ALGORITHMS, PROVINCIAL, ANALYTICAL, WITHDRAWAL, VOCATIONAL, TRANSEXUAL, BEHAVIORAL, BENEFICIAL, ECOLOGICAL, ABORIGINAL, GEOLOGICAL, OCCASIONAL, ALEXANDRIA, PERIPHERAL, CONCEPTUAL, EDUCATIONAL, ALTERNATIVE, TRADITIONAL, RESIDENTIAL, INTERRACIAL, STATISTICAL, OPERATIONAL, FUNDAMENTAL, SUBSTANTIAL, PROMOTIONAL, CONTINENTAL, DIMENSIONAL, THEORETICAL, EXCEPTIONAL, ALBUQUERQUE, NUTRITIONAL, TRANSSEXUAL, CONDITIONAL, PROFESSIONAL, AGRICULTURAL, INTELLECTUAL, EXPERIMENTAL, ALTERNATIVES, CONVENTIONAL, OCCUPATIONAL, ALPHABETICAL, MATHEMATICAL, CONFIDENTIAL, PRESIDENTIAL, GOVERNMENTAL, RECREATIONAL, DIFFERENTIAL, GEOGRAPHICAL, INSTRUMENTAL, SUPPLEMENTAL, HYPOTHETICAL, DEPARTMENTAL, INTERNATIONAL, INTERNATIONAL, ENVIRONMENTAL, INSTITUTIONAL, INFORMATIONAL, ARCHITECTURAL, PSYCHOLOGICAL, INSTRUCTIONAL, TECHNOLOGICAL, CONGRESSIONAL, DEVELOPMENTAL, COMPUTATIONAL, ALTERNATIVELY, CONTROVERSIAL, PHARMACEUTICAL, ORGANIZATIONAL, CONSTITUTIONAL
