TH - THE, THAT, THIS, WITH, THEY, THEIR, THERE, THESE, THAN, HEALTH
HE - THE, HERE, HELP, HEALTH, HER, SHE, HEAD, HEART, HELD, HEAR
ND - AND, FIND, SEND, FOUND, END, AROUND, SECOND, FRIEND, HAND, LAND
ES - SERVICES, DOES, GAMES, STATES, PRICES, PAGES, RESOURCES, PICTURES, TIMES, SITES
AN - AND, CAN, ANY, THAN, JAN, AMERICAN, ANOTHER, MAN, PLAN, HUMAN
ER - OTHER, OVER, HER, NUMBER, AFTER, ORDER, USER, UNDER, CENTER, MEMBER
NG - USING, SHIPPING, LONG, BEING, FOLLOWING, INCLUDING, RATING, DURING, SHOPPING, LISTING
CO - CONTACT, COPYRIGHT, COMPANY, COULD, COMMENTS, COMMUNITY, CODE, COUNTY, COMPUTER, CONTROL
ED - USED, NEED, UNITED, EDUCATION, POSTED, RESERVED, BASED, RELATED, ADVANCED, PROVIDED
ON - ONE, INFORMATION, ONLY, ONLINE, EDUCATION, VERSION, SECTION, LOCATION, DESCRIPTION, NON
RE - ARE, MORE, THERE, HERE, WERE, SOFTWARE, WHERE, REVIEW, READ, RESEARCH
PR - PRICE, PRODUCTS, PRODUCT, PRIVACY, PROGRAM, PRICES, PROJECT, PROFILE, PREVIOUS, PROPERTY
AL - ALL, ALSO, GENERAL, REAL, INTERNATIONAL, LOCAL, NATIONAL, SPECIAL, TOTAL, PERSONAL
FO - FOR, INFO, FORUM, FOUND, FOLLOWING, FORM, FOOD, FORUMS, FOUR, FORMAT
OR - FOR, ORDER, AUTHOR, MAJOR, ORIGINAL, COLOR, DIRECTOR, ERROR, ORDERS, ORGANIZATION
SE - SEARCH, USE, SEE, SERVICES, THESE, SERVICE, PLEASE, SEX, SET, SEND
IN - INFORMATION, INTO, INFO, INTERNATIONAL, INTERNET, WITHIN, INDEX, INCLUDING, MAIN, INSURANCE
TS - ITS, PRODUCTS, RIGHTS, COMMENTS, RESULTS, SPORTS, POSTS, STUDENTS, EVENTS, REPORTS
NT - MANAGEMENT, DEVELOPMENT, WANT, CURRENT, GOVERNMENT, ACCOUNT, DEPARTMENT, CONTENT, DIFFERENT, PRINT
MA - MAY, MAKE, MANY, MAIL, MAP, MANAGEMENT, MADE, MAIN, MAN, MARKET
ST - FIRST, LIST, JUST, STATE, LAST, MOST, POST, BEST, MUST, STORE
WI - WITH, WILL, WITHIN, WITHOUT, WINDOWS, WINDOW, WIDE, WIRELESS, WISH, WIN
CA - CAN, CAR, CASE, CARE, CALL, CARD, CANADA, CATEGORIES, CATEGORY, CART
LL - ALL, WILL, WELL, FULL, SMALL, CALL, SHALL, STILL, SELL, CELL
CE - SERVICE, PRICE, CENTER, OFFICE, PLACE, SINCE, INSURANCE, SOURCE, SCIENCE, PERFORMANCE
LE - PEOPLE, AVAILABLE, FILE, WHILE, LEVEL, PROFILE, TITLE, LITTLE, ARTICLE, LEARN
TE - SITE, DATE, STATE, TERMS, WEBSITE, TECHNOLOGY, WHITE, TEXT, RATE, PRIVATE
YO - YOU, YOUR, YORK, YOUNG, YOURSELF, YOUTH, YOURS, YOGA, TOKYO, YOUNGER
DE - MADE, DEVELOPMENT, DETAILS, DESIGN, CODE, GUIDE, DEPARTMENT, DESCRIPTION, DECEMBER, INCLUDE
AT - THAT, WHAT, GREAT, FORMAT, CHAT, SAT, FAT, CAT, FLAT, ATTENTION
PA - PAGE, PART, PAGES, PARTY, PAYMENT, PARK, PAPER, PASSWORD, PAY, PAST
RS - YEARS, MEMBERS, HOURS, USERS, OFFERS, RSS, COMPUTERS, OTHERS, CARS, CUSTOMERS
NO - NOT, NOW, NORTH, NON, NOTE, NOVEMBER, NOV, NOTICE, NONE, NOTES
MO - MORE, MOST, MONEY, MOVIES, MODEL, MOVIE, MOBILE, MONTH, MONTHS, MODELS
RY - VERY, JANUARY, HISTORY, DIRECTORY, EVERY, COUNTRY, CATEGORY, GALLERY, LIBRARY, INDUSTRY
ME - HOME, TIME, SOME, NAME, MESSAGE, MEMBER, SAME, GAME, MEMBERS, MEDIA
EN - WHEN, BEEN, THEN, BETWEEN, EVEN, WOMEN, OPEN, END, CHILDREN, TEEN
LY - ONLY, FAMILY, REPLY, REALLY, JULY, DAILY, EARLY, USUALLY, LYRICS, CURRENTLY
VE - HAVE, VERY, VERSION, LOVE, SAVE, LIVE, ABOVE, GIVE, ARCHIVE, DRIVE
LI - LIKE, LIST, LINKS, LIFE, LINE, LINK, LISTING, LITTLE, LIVE, LIBRARY
HO - HOME, WHO, HOW, HOTEL, HOTELS, HOUSE, HOURS, HOWEVER, HOT, HOSTING
NE - NEW, ONE, NEWS, ONLINE, NEXT, NEED, LINE, PHONE, NETWORK, JUNE
HA - HAVE, HAS, HAD, HARD, HAND, HAVING, HALF, HARDWARE, HAPPY, HALL
IS - THIS, HIS, ISSUES, ISSUE, ANALYSIS, ISLAND, ISLANDS, BASIS, ISBN, PARIS
NS - CONDITIONS, QUESTIONS, OPTIONS, SOLUTIONS, MEANS, APPLICATIONS, LOANS, PLANS, TEENS, RETURNS
AR - ARE, YEAR, CAR, AREA, ART, ARTICLE, AROUND, ARTICLES, WAR, STAR
FR - FROM, FREE, FRIEND, FRIENDS, FRANCE, FRONT, FRIDAY, FRENCH, FRI, FRIENDLY
GE - PAGE, GET, MESSAGE, GENERAL, CHANGE, IMAGE, COLLEGE, LARGE, LANGUAGE, AGE
CH - SEARCH, WHICH, SUCH, EACH, RESEARCH, CHECK, MUCH, CHANGE, CHILDREN, MARCH
PO - POST, POLICY, POSTED, POWER, POSTS, POINT, POKER, POSSIBLE, PORN, POPULAR
WH - WHAT, WHICH, WHEN, WHO, WHERE, WHILE, WHITE, WHY, WHETHER, WHOLE
TY - CITY, UNIVERSITY, TYPE, COMMUNITY, SECURITY, COUNTY, PROPERTY, QUALITY, PARTY, SOCIETY
BE - BEEN, BEST, BEFORE, BECAUSE, BETWEEN, BEING, BETTER, BELOW, BECOME, BEACH
AY - MAY, DAY, WAY, EBAY, TODAY, GAY, SAY, PLAY, PAY, AWAY
DI - DID, DIRECTORY, DIGITAL, DIFFERENT, DISCUSSION, DISPLAY, DIRECTOR, DIRECT, DISTRICT, DISCOUNT
FI - FIRST, FIND, FILE, FINANCIAL, FIELD, FILES, FILM, FIVE, FINAL, FINANCE
SU - SUCH, SUPPORT, SUBJECT, SUN, SURE, SUBSCRIBE, SUBMIT, SUMMARY, SUPPLIES, SUNDAY
WA - WAS, WAY, WANT, WATER, WAR, WASHINGTON, WATCH, WANTED, WALL, WARNING
UT - ABOUT, BUT, OUT, WITHOUT, PUT, CUT, INPUT, OUTPUT, THROUGHOUT, CHECKOUT
UR - YOUR, OUR, FOUR, URL, EUR, TOUR, HOUR, AMATEUR, URBAN, COLOUR
LO - LOCAL, LONG, LOCATION, LOVE, LOW, LOOK, LOOKING, LOGIN, LONDON, LOG
AS - WAS, HAS, TEXAS, AREAS, ASSOCIATION, ASK, ASKED, GAS, CHRISTMAS, IDEAS
SH - SHOULD, SHE, SHIPPING, SHOW, SHOP, SHOPPING, SHALL, ENGLISH, SHARE, SHORT
OT - NOT, OTHER, HOT, GOT, OTHERS, LOT, OTHERWISE, ROOT, SHOT, FOOT
SS - BUSINESS, ADDRESS, ACCESS, CLASS, PRESS, PROCESS, LESS, RSS, WIRELESS, LOSS
SO - ALSO, SOME, SOFTWARE, SOUTH, SOURCE, SOCIAL, SOMETHING, SOCIETY, SOLUTIONS, SOUND
WE - WEB, WERE, WELL, WEBSITE, WEST, WEEK, WELCOME, WEATHER, WEIGHT, WESTERN
SI - SITE, SIGN, SIZE, SINCE, SITES, SIDE, SINGLE, SIMILAR, SIMPLE, SILVER
BU - BUT, BUSINESS, BUY, BUILDING, BUILD, BUSH, BUTTON, BUILT, BUDGET, BUYING
CT - CONTACT, PRODUCT, SUBJECT, PROJECT, SELECT, ACT, OCT, DIRECT, DISTRICT, FACT
OM - FROM, ROOM, KINGDOM, COM, CUSTOM, TOM, BOTTOM, RANDOM, FREEDOM, ATOM
ET - GET, SET, INTERNET, MARKET, STREET, LET, YET, NET, MEET, CNET
TR - TRAVEL, TRAINING, TRY, TRACK, TRADE, TRUE, TREATMENT, TRANSFER, TREE, TRYING
CK - CLICK, BACK, BLACK, CHECK, STOCK, FEEDBACK, TRACK, ROCK, QUICK, PACK
OU - YOU, OUR, OUT, OUTSIDE, OUTPUT, OUTDOOR, OUTDOORS, OUTLET, OUTSTANDING, OUTLOOK
TO - TOP, INTO, TODAY, PHOTO, TOTAL, TOOLS, TOO, TOPIC, TOPICS, AUTO
LD - WOULD, WORLD, SHOULD, COULD, OLD, FIELD, CHILD, GOLD, BUILD, HELD
EW - NEW, VIEW, REVIEW, FEW, OVERVIEW, INTERVIEW, KNEW, ANDREW, PREVIEW, CREW
RT - SUPPORT, PART, REPORT, ART, START, CART, COURT, SHORT, HEART, SORT
WO - WOULD, TWO, WORLD, WORK, WOMEN, WORKING, WORD, WORKS, WORDS, WOMAN
OW - NOW, HOW, KNOW, SHOW, OWN, LOW, BELOW, WINDOW, YELLOW, FOLLOW
BA - BACK, BASED, BABY, BAD, BANK, BASIC, BASE, BAY, BAR, BAND
SA - SAID, SAME, USA, SAVE, SALE, SALES, SAY, SAN, SAFETY, SAYS
IC - MUSIC, PUBLIC, TOPIC, SPECIFIC, ECONOMIC, BASIC, ELECTRONIC, CLASSIC, TRAFFIC, REPUBLIC
DS - NEEDS, CARDS, FRIENDS, RECORDS, DOWNLOADS, KIDS, WORDS, METHODS, STANDARDS, ISLANDS
LA - LAST, LAW, LARGE, LANGUAGE, LATEST, LAND, LAKE, LATER, LATE, LARGER
DA - DATE, DAY, DATA, DAYS, CANADA, DAVID, DAILY, DATABASE, FLORIDA, DATING
PE - PEOPLE, TYPE, PER, PERSONAL, PERSON, PERFORMANCE, PERIOD, EUROPE, PERCENT, HOPE
LS - DETAILS, HOTELS, TOOLS, GIRLS, SCHOOLS, DEALS, MODELS, MATERIALS, SKILLS, LEVELS
AD - HAD, ADD, READ, ADDRESS, DOWNLOAD, ADVANCED, THREAD, ADDITIONAL, ROAD, ADDED
EE - FREE, SEE, THREE, COMMITTEE, DEGREE, TREE, FEE, AGREE, EMPLOYEE, LEE
AC - ACCESS, ACCOUNT, ACTION, ACCESSORIES, ACT, ACTIVITIES, ACTIVE, ACTIVITY, ACROSS, ACCORDING
US - USE, USED, USER, USING, USA, PREVIOUS, USERS, STATUS, PLUS, USUALLY
BO - BOOKS, BOOK, BOTH, BOARD, BOX, BODY, BOY, BOYS, BOARDS, BORN
EX - SEX, INDEX, EXPERIENCE, EXAMPLE, EXCHANGE, EXECUTIVE, EXCELLENT, EXPRESS, EXTRA, EXISTING
VI - VIEW, VIDEO, VISIT, VIA, VIDEOS, VIEWS, VIRGINIA, VIRTUAL, VISUAL, VISITORS
FA - FAMILY, FAX, FAQ, FAST, FACT, FAR, FACE, FACILITIES, FALL, FAVORITE
CL - CLICK, CLASS, CLUB, CLOSE, CLEAR, CLOTHING, CLIENT, CLASSIC, CLASSES, CLEAN
MI - MIGHT, MILLION, MICROSOFT, MILES, MINUTES, MICHAEL, MIND, MILITARY, MIDDLE, MINI
SP - SPECIAL, SPORTS, SPACE, SPECIFIC, SPEED, SPONSORED, SPRING, SPORT, SPAIN, SPECIFIED
DO - DOES, DOWN, DOWNLOAD, DONE, DOWNLOADS, DOCUMENT, DOMAIN, DOING, DOUBLE, DOG
HI - HIS, HIGH, HIM, HISTORY, HIGHER, HILL, HIT, HITS, HIGHEST, HIGHLY
PL - PLEASE, PLACE, PLAN, PLAY, PLANNING, PLUS, PLAYER, PLAYERS, PLANS, PLANT
UN - UNDER, UNIVERSITY, UNITED, SUN, RUN, UNTIL, FUN, UNIT, JUN, UNION
EL - HOTEL, TRAVEL, LEVEL, MODEL, ELECTRONICS, ELSE, FEEL, MICHAEL, ELECTRONIC, CHANNEL
GR - GROUP, GREAT, GROUPS, GREEN, GROWTH, GROUND, GRAND, GREATER, GRAPHICS, GRADE
TI - TIME, TIMES, TITLE, TICKETS, TIPS, ANTI, MULTI, TITLES, TITS, TIP
MS - ITEMS, TERMS, SYSTEMS, FORUMS, PROGRAMS, PROBLEMS, ROOMS, FORMS, SEEMS, MSN
RA - RATING, RATE, RATES, RANGE, RADIO, CAMERA, RATHER, RATINGS, EXTRA, RATED
RD - BOARD, CARD, STANDARD, PASSWORD, HARD, RECORD, WORD, THIRD, AWARD, FORWARD
NY - ANY, COMPANY, MANY, GERMANY, SONY, FUNNY, TONY, TINY, ANTHONY, TIFFANY
AB - ABOUT, ABOVE, ABLE, ABSTRACT, ABILITY, ABUSE, LAB, ARAB, ABSOLUTELY, TAB
EY - THEY, MONEY, KEY, SURVEY, VALLEY, EYE, JERSEY, EYES, ATTORNEY, TURKEY
KS - BOOKS, LINKS, WORKS, THANKS, WEEKS, NETWORKS, TRADEMARKS, LOOKS, BANKS, PARKS
GO - GOOD, GOVERNMENT, GOING, GOT, GOD, GOLD, AGO, GOLF, GOOGLE, LOGO
BR - BROWSE, BRAND, BRITISH, BROWSER, BROWN, BRING, BRANDS, BREAK, BREAST, BROUGHT
HT - COPYRIGHT, RIGHT, NIGHT, LIGHT, MIGHT, WEIGHT, HTML, THOUGHT, BROUGHT, FLIGHT
IL - EMAIL, MAIL, APRIL, UNTIL, COUNCIL, OIL, RETAIL, CIVIL, DETAIL, ILLINOIS
FE - LIFE, FEATURES, FEEDBACK, FEW, FEBRUARY, FEB, FEDERAL, FEEL, FEATURED, FEMALE
KE - LIKE, MAKE, TAKE, KEY, KEEP, LAKE, KEYWORDS, MIKE, KEYWORD, KELLY
WS - NEWS, REVIEWS, WINDOWS, SHOWS, VIEWS, ALLOWS, LAWS, FOLLOWS, KNOWS, INTERVIEWS
SC - SCHOOL, SCIENCE, SCHOOLS, SCREEN, SCORE, SCHEDULE, SCALE, SCIENCES, SCIENTIFIC, SCOTT
TA - DATA, TAKE, TABLE, TAX, TALK, TAKEN, TAKING, TAKES, TARGET, TASK
AP - MAP, APPLICATION, APRIL, APPLICATIONS, APR, CHEAP, APPLY, APPROPRIATE, APPROACH, APPROVED
IA - MEDIA, CALIFORNIA, AUSTRALIA, VIA, INDIA, VIRGINIA, NOKIA, ASIA, GEORGIA, COLUMBIA
GA - GAMES, GAME, GAY, GALLERY, GARDEN, GAS, GALLERIES, GAVE, GAMMA, GAIN
IT - ITS, ITEMS, ITEM, VISIT, CREDIT, EDIT, UNIT, SUBMIT, BIT, ITALY
NA - NAME, NATIONAL, CHINA, NATURAL, NATURE, NAMES, NAVIGATION, CAROLINA, NATION, NAKED
RO - ROOM, ROAD, PRO, ROCK, ROLE, ROBERT, ROOMS, ROUND, ROYAL, ROOT
PU - PUBLIC, PUT, PUBLISHED, PURCHASE, PURPOSE, PUBLICATIONS, PUBLISHER, PUSSY, PUBLICATION, PURPOSES
FU - FULL, FUTURE, FURTHER, FUN, FUNCTION, FURNITURE, FUND, FUNDS, FUNCTIONS, FULLY
PH - PHONE, PHOTO, PHOTOS, PHONES, PHYSICAL, PHOTOGRAPHY, PHP, PHENTERMINE, PHASE, JOSEPH
EM - EMAIL, THEM, SYSTEM, ITEM, PROBLEM, EMPLOYMENT, EMPLOYEES, EMPLOYEE, EMERGENCY, SEEM
AU - AUTHOR, AUGUST, AUDIO, AUSTRALIA, AUG, AUTO, AUTHORITY, AUTHORS, AUSTRALIAN, AUCTION
MU - MUSIC, MUST, MUCH, MULTIPLE, MULTI, MUSEUM, MUSICAL, MULTIMEDIA, MUSCLE, MUNICIPAL
EV - EVEN, EVENTS, EVERY, EVENT, EVER, EVERYTHING, EVERYONE, EVIDENCE, PREV, EVALUATION
ID - SAID, DID, DAVID, BID, IDEAS, IDEA, PAID, VALID, AID, MID
JO - JOHN, JOBS, JOB, JOIN, JOURNAL, JOINED, JOHNSON, JONES, JOINT, JOE
RI - RIGHTS, RIGHT, RISK, RIVER, FRI, RING, RICHARD, RINGTONES, RICH, MISSOURI
RK - WORK, NETWORK, YORK, PARK, MARK, DARK, FRAMEWORK, BOOKMARK, TRADEMARK, CLARK
OF - OFF, OFFICE, OFFERS, OFFER, OFFICIAL, OFTEN, OFFERED, OFFICER, OFFERING, OFFICES
CR - CREDIT, CREATE, CREATED, CROSS, CREATIVE, CRITICAL, CRIME, CREATING, CREEK, CRIMINAL
JU - JUST, JUNE, JULY, JUL, JUN, JUSTICE, JUMP, JUDGE, JUNIOR, JUDGMENT
JA - JAN, JANUARY, JAMES, JAPAN, JAVA, JAPANESE, JACK, JACKSON, JAZZ, JAVASCRIPT
QU - QUALITY, QUESTIONS, QUOTE, QUESTION, QUICK, QUITE, QUOTES, QUICKLY, QUANTITY, QUARTER
YE - YEAR, YEARS, YES, YET, YELLOW, EYE, YESTERDAY, YEAH, AYE, YEA
IR - THEIR, AIR, HAIR, IRELAND, IRAQ, REPAIR, FAIR, CHAIR, IRON, PAIR
BI - BIG, BILL, BIT, BID, BIN, BIBLE, BIRTH, BINDING, BILLION, BIRTHDAY
CU - CURRENT, CUSTOMER, CURRENTLY, CUSTOMERS, CULTURE, CUSTOM, CUT, CUP, CURRENCY, CUM
OP - TOP, OPEN, SHOP, OPTIONS, STOP, OPPORTUNITIES, OPERATING, OPERATIONS, OPTION, OPPORTUNITY
OD - GOOD, FOOD, GOD, PERIOD, METHOD, BLOOD, WOOD, IPOD, NEIGHBORHOOD, HOLLYWOOD
GS - THINGS, LISTINGS, RATINGS, SONGS, BLOGS, SETTINGS, MEETINGS, DRUGS, TAGS, SAVINGS
UE - VALUE, ISSUE, BLUE, DUE, TRUE, CONTINUE, TUE, UNIQUE, LEAGUE, AVENUE
CY - POLICY, PRIVACY, AGENCY, EMERGENCY, CURRENCY, FREQUENCY, CYCLE, ACCURACY, PHARMACY, PREGNANCY
AG - AGAIN, AGAINST, AGE, AGREEMENT, AGO, AGENCY, AGENT, AGENTS, AGREE, AGENCIES
EA - EACH, AREA, EAST, EASY, EARLY, IDEA, SEA, EARTH, EASILY, EASTERN
IM - HIM, IMAGE, IMPORTANT, IMAGES, IMPROVE, IMPACT, IMPLEMENTATION, CLAIM, JIM, IMMEDIATELY
BL - BLACK, BLOG, BLUE, BLOOD, BLOCK, BLOGS, BLOW, BLONDE, BLUES, BLUETOOTH
RN - RETURN, LEARN, PORN, TURN, WESTERN, MODERN, NORTHERN, BORN, SOUTHERN, EASTERN
GH - HIGH, THROUGH, THOUGH, ENOUGH, ALTHOUGH, PITTSBURGH, GHOST, EDINBURGH, TOUGH, ROUGH
AM - PROGRAM, AMERICAN, TEAM, AMERICA, AMOUNT, AMONG, WILLIAM, AMAZON, AMATEUR, STREAM
OL - SCHOOL, CONTROL, OLD, TOOL, COOL, POOL, VOL, OLDER, PROTOCOL, ALCOHOL
YS - DAYS, ALWAYS, SAYS, TOYS, WAYS, BOYS, HOLIDAYS, GUYS, KEYS, PLAYS
VA - VALUE, VARIOUS, VALUES, VALLEY, VALID, JAVA, VAN, VACATION, VARIETY, VARIABLE
PI - PICTURES, PICTURE, PICS, PIECE, PINK, PICK, PIC, PIECES, PIN, MISSISSIPPI
PS - GROUPS, TIPS, MAPS, SHIPS, PST, PERHAPS, STEPS, SHOPS, CLIPS, UPS
CS - ELECTRONICS, TOPICS, LYRICS, PICS, STATISTICS, GRAPHICS, POLITICS, ECONOMICS, COMICS, PHYSICS
UM - FORUM, ALBUM, MAXIMUM, MEDIUM, MINIMUM, MUSEUM, CUM, PREMIUM, ZUM, CURRICULUM
WN - OWN, DOWN, TOWN, KNOWN, SHOWN, BROWN, UNKNOWN, DOWNTOWN, CROWN, DRAWN
NK - LINK, THINK, BANK, THANK, PINK, RANK, FRANK, DRINK, PERMALINK, INK
DR - DRIVE, DRUG, DRIVER, DRIVING, DRUGS, DROP, DRAFT, DREAM, DRY, DRIVERS
GI - GIVE, GIRLS, GIFT, GIVEN, GIFTS, GIRL, GIVES, GIVING, GIANT, CGI
CI - CITY, CITIES, CIVIL, CISCO, CIRCUIT, CITIZENS, CIRCLE, CIRCUMSTANCES, CINEMA, SCI
SY - SYSTEM, SYSTEMS, EASY, PUSSY, FANTASY, SYDNEY, SYMBOL, SYMPTOMS, BUSY, SYNTAX
GU - GUIDE, GUIDES, GUEST, GUY, GUIDELINES, GUARANTEE, GUYS, GUITAR, GUESS, GUARANTEED
FL - FLORIDA, FLASH, FLOWERS, FLOOR, FLAT, FLOW, FLIGHT, FLOWER, FLAG, FLIGHTS
NU - NUMBER, NUDE, MENU, NUMBERS, NURSING, NUCLEAR, NULL, NUTRITION, GNU, NUMEROUS
AF - AFTER, AFRICA, AFRICAN, AFFILIATE, AFFAIRS, AFFILIATES, AFFECT, AFFECTED, AFFORDABLE, AFTERNOON
AV - AVAILABLE, AVERAGE, AVAILABILITY, AVOID, AVENUE, AVE, AVG, AVATAR, AVIATION, NAV
DY - STUDY, BODY, ALREADY, READY, LADY, DYNAMIC, BUDDY, COMEDY, ANDY, EVERYBODY
KI - KIDS, KINGDOM, KING, KIND, KITCHEN, KIT, KINDS, SKI, KILL, KITS
IP - ZIP, SHIP, MEMBERSHIP, TRIP, RELATIONSHIP, SKIP, IPOD, LEADERSHIP, CLIP, PARTNERSHIP
OK - BOOK, LOOK, TOOK, OKLAHOMA, COOK, NOTEBOOK, OUTLOOK, HANDBOOK, OKAY, GUESTBOOK
RM - FORM, TERM, FARM, FIRM, PLATFORM, PERFORM, ARM, REFORM, CONFIRM, WARM
OV - OVER, NOV, OVERALL, OVERVIEW, OVERSEAS, OVERNIGHT, OVEN, OVERCOME, OVAL, OVERHEAD
KN - KNOW, KNOWLEDGE, KNOWN, KNEW, KNOWS, KNOWING, KNIGHT, KNIFE, KNEE, KNIVES
FT - LEFT, GIFT, MICROSOFT, SOFT, DRAFT, AIRCRAFT, SHIFT, FTP, CRAFT, LIFT
RU - RUN, RULES, RUNNING, RULE, RUSSIAN, RUSSIA, RURAL, RUNS, RUBBER, RUSSELL
FF - OFF, STAFF, STUFF, DIFF, JEFF, PLAINTIFF, CARDIFF, CLIFF, TARIFF, SHERIFF
GY - TECHNOLOGY, ENERGY, STRATEGY, PSYCHOLOGY, BIOLOGY, ORGY, METHODOLOGY, GENEALOGY, GYM, BIOTECHNOLOGY
UP - GROUP, UPDATED, UPON, UPDATE, UPDATES, CUP, UPGRADE, UPPER, UPS, BACKUP
LF - SELF, GOLF, HALF, YOURSELF, ITSELF, MILF, HIMSELF, MYSELF, BEHALF, GULF
VO - VOLUME, VOICE, VOTE, VOL, VOID, VOTES, VOYEUR, VOLUNTEER, VOIP, VOTING
TW - TWO, TWENTY, TWIN, TWICE, TWIKI, TWELVE, TWINKS, TWINS, TWIST, TWISTED
DU - DURING, DUE, DUTY, DUAL, DUTCH, DURATION, DUTIES, DUBLIN, DUST, DUKE
LT - RESULT, ADULT, LTD, BUILT, DEFAULT, DIFFICULT, FELT, SALT, BELT, FAULT
HU - HUMAN, HUGE, THU, HUNTER, HUSBAND, HUNDREDS, HUNTING, HUNDRED, HUMOR, HURRICANE
WR - WRITE, WRITTEN, WRITING, WROTE, WRONG, WRITER, WRITERS, WRITES, WRIGHT, WRAP
UL - JUL, PAUL, BEAUTIFUL, USEFUL, HELPFUL, SUCCESSFUL, POWERFUL, SOUL, ULTIMATE, WONDERFUL
OS - PHOTOS, VIDEOS, LOS, LOGOS, CASINOS, STUDIOS, FOTOS, LYCOS, DILDOS, DOS
IO - AUDIO, RADIO, STUDIO, OHIO, ONTARIO, IOWA, PORTFOLIO, RATIO, ANTONIO, BIO
TU - TURN, TUESDAY, TUE, TURNED, TURKEY, TUTORIAL, TUTORIALS, TUBE, TURNS, TURNING
OC - OCTOBER, OCT, OCEAN, DOC, OCCUR, OCCURRED, OCCURS, OCCUPATION, OCCUPATIONAL, OCCASION
OG - BLOG, LOG, DOG, CATALOG, WEBLOG, ANALOG, DIALOG, FROG, FOG, CHANGELOG
SM - SMALL, SMITH, SMART, TOURISM, SMOKING, SMALLER, SMOOTH, MECHANISM, SMOKE, TERRORISM
AI - AIR, AIRPORT, AID, HENTAI, AIDS, AIM, AIRCRAFT, AIRLINE, AIRLINES, THAI
EP - KEEP, SEP, STEP, DEEP, SLEEP, EPISODE, EPINIONS, EPSON, EPA, REP
NI - NIGHT, NICE, MINI, NINE, NIGHTS, ALUMNI, NICK, NINTENDO, NIKON, NIPPLES
IE - MOVIE, DIE, LINGERIE, TIE, LIE, MARIE, CHARLIE, IEEE, COOKIE, PIE
JE - JEWELRY, JERSEY, JESUS, JEFF, JEAN, JEWISH, JENNIFER, JEWELLERY, JET, JESSICA
HY - WHY, PHOTOGRAPHY, HEALTHY, PHILOSOPHY, BIOGRAPHY, GEOGRAPHY, HYBRID, BIBLIOGRAPHY, MURPHY, THY
EF - EFFECTS, EFFECTIVE, EFFECT, CHIEF, EFFORT, EFFORTS, BRIEF, RELIEF, EFFICIENCY, EFFICIENT
OB - JOB, OBJECT, BOB, OBJECTS, OBTAINED, OBTAIN, OBJECTIVES, OBSERVED, BLOWJOB, OBJECTIVE
BS - JOBS, CLUBS, BOOBS, BLOWJOBS, LBS, TABS, LABS, THUMBS, CBS, HERBS
PT - EXCEPT, ACCEPT, SCRIPT, CONCEPT, KEPT, JAVASCRIPT, ATTEMPT, EGYPT, RECEIPT, ADOPT
ZE - SIZE, ZEALAND, ZERO, PRIZE, RECOGNIZE, REALIZE, CUSTOMIZE, BRONZE, ANALYZE, ORGANIZE
AW - LAW, AWAY, AWARD, AWARDS, SAW, AWARE, RAW, DRAW, AWARENESS, AWARDED
SK - ASK, RISK, SKILLS, SKIN, SKIP, TASK, DISK, DESK, SKI, SKY
GL - GLOBAL, GLASS, GLOSSARY, GLANCE, GLAD, GLOBE, GLASSES, GLORY, GLASGOW, GLOVES
OX - BOX, XBOX, FOX, OXFORD, FIREFOX, OXYGEN, APPROX, COX, SOX, TOOLBOX
EQ - EQUIPMENT, EQUAL, EQUITY, EQUIVALENT, EQUATION, EQUIPPED, EQUALLY, EQUATIONS, EQUALITY, EQUILIBRIUM
IG - BIG, FIG, IGNORE, CONFIG, CRAIG, IGNORED, DIG, PIG, SIG, GIG
SL - SLIGHTLY, SLEEP, SLOW, DSL, SLIDE, SLOT, SLOWLY, SLIP, SLOTS, SLEEPING
UG - AUG, DRUG, BUG, PLUG, DOUG, DEBUG, UGANDA, UGLY, RUG, MUG
IX - SIX, MIX, FIX, MATRIX, PHOENIX, UNIX, APPENDIX, REMIX, PREFIX, PRIX
SW - SWITCH, SWEET, SWEDEN, SWITZERLAND, SWISS, SWIMMING, NSW, SWING, SWEDISH, SWITCHES
EC - DEC, ECONOMIC, ECONOMY, SEC, ECONOMICS, ECHO, NEC, QUEBEC, ECOMMERCE, SPEC
HS - MONTHS, VHS, PHOTOGRAPHS, DEATHS, PATHS, HIGHS, NHS, STRENGTHS, GRAPHS, BATHS
BY - BABY, BYTES, NEARBY, RUGBY, RUBY, BYTE, BOBBY, THEREBY, HOBBY, HEREBY
OY - BOY, ENJOY, TOY, JOY, ROY, DESTROY, TROY, PLAYBOY, COWBOY, EMPLOY
MY - ECONOMY, ARMY, MYSELF, ACADEMY, MYSQL, MYSTERY, ENEMY, JIMMY, AMY, ASTRONOMY
MP - JUMP, CAMP, PUMP, MPH, MPEG, LAMP, AMP, TEMP, STAMP, COMP
LU - LUXURY, LUNCH, LUCK, LUCKY, FLU, LUNG, LUXEMBOURG, LUGGAGE, LUKE, HONOLULU
KA - KANSAS, ALASKA, NEBRASKA, KATE, KAREN, AKA, KATRINA, LANKA, KATIE, KARAOKE
