THE - THERE, THEATRE, THEOREM, THEME, THEORIES, THESE, THEREOF
RES - RESPONSE, RESORT, RESPECT, RESOURCE, RESOURCES, RESPONSES, RESULTS
INT - INTEREST, INTERNET, INTERACTIVE, INTERACTION, INTERESTS, INTERESTED, INTERFACE
STA - STATS, STATES, STATE, START, STATED, STARTED, STATIONS
HEA - HEADER, HEART, HEADERS, HEARD, HEADS, HEARTS, HEATHER
DES - DESIGNER, DESIGNED, DESIGNERS, DESIGN, DESIGNS, DESIGNATED, DESIRE
INS - INSTANT, INSTRUCTION, INSTITUTE, INSTANCE, INSTITUTION, INSTRUCTIONS, INSTALLING
DIS - DISCUSSED, DISCUSS, DISTANCE, DISEASE, DISNEY, DISEASES, DISCOUNTS
REA - READS, REASON, READING, READY, READINGS, REACTION, REALITY
ASS - ASSET, ASSETS, ASSOCIATES, ASSOCIATE, ASSIST, ASSUMES, ASSOCIATED
IND - INDICATE, INDIA, INDICATED, INDICATES, INDIAN, INDIANA, INDEED
TRA - TRAIN, TRACKING, TRANSIT, TRADING, TRANSACTION, TRAIL, TRACKS
STR - STRANGE, STRENGTH, STREET, STRATEGY, STRING, STREETS, STRIKE
FIN - FINDINGS, FINANCES, FINANCE, FINISH, FINDING, FINDS, FINNISH
SPE - SPECIAL, SPECIALS, SPECIES, SPECIALIST, SPECS, SPECIALTY, SPECIFY
ATT - ATTACHED, ATTEND, ATTACHMENT, ATTACHMENTS, ATTENDANCE, ATTRACTIVE, ATTRACTION
REL - RELATE, RELATION, RELATIVE, RELATED, RELATIONS, RELATING, RELEASE
SHA - SHARE, SHARED, SHARES, SHAPE, SHADE, SHAPED, SHAKE
TRI - TRIES, TRIBE, TRIBES, TRIAL, TRIALS, TRIBAL, TRIPLE
GEN - GENERATE, GENERAL, GENES, GENERIC, GENRE, GENERATION, GENERATED
PRE - PRESENT, PRESENTS, PREVENT, PRESIDENT, PREVENTION, PRESENTED, PRESENCE
PRI - PRINCE, PRINTER, PRINT, PRINTERS, PRICE, PRINTED, PRINTS
PER - PERSON, PERSONS, PERSONAL, PERSONNEL, PERSONALS, PERFORMANCE, PERIOD
MIN - MINISTER, MINES, MINISTERS, MINUTES, MINISTRY, MINUTE, MINERALS
REG - REGARD, REGULAR, REGARDS, REGULATIONS, REGISTRAR, REGISTER, REGARDING
REC - RECEIVED, RECEIVE, RECENT, RECIPE, RECEIVER, RECORDED, RECOMMEND
REP - REPORT, REPRESENT, REPORTS, REPEAT, REPLIES, REPORTED, REPAIRS
INC - INCREASE, INCLUDES, INCREASED, INCEST, INCREASES, INCLUDE, INCREASING
CHE - CHEST, CHECKS, CHEAT, CHEATS, CHEERS, CHESTER, CHEAPEST
INV - INVEST, INVESTOR, INVESTING, INVENTION, INVITE, INVESTORS, INVOLVES
REF - REFER, REFERS, REFINE, REFINED, REFERRED, REFERENCE, REFUSE
SHO - SHOES, SHOWS, SHOWER, SHOTS, SHORTS, SHORT, SHORE
REM - REMAINED, REMAIN, REMAINDER, REMIND, REMINDER, REMAINS, REMOVE
SUB - SUBSECTION, SUBSCRIBE, SUBSTANCE, SUBSTITUTE, SUBSCRIBER, SUBMIT, SUBSTANCES
CHA - CHANGE, CHARGE, CHANGES, CHARGES, CHANGED, CHARGED, CHANCE
MAR - MARIE, MARIA, MARINE, MARKET, MARTIN, MARTIAL, MARKETS
HAR - HARDER, HARRY, HARBOR, HARPER, HARDCORE, HARDCOVER, HAROLD
SUR - SURREY, SURVIVE, SURVEY, SURPRISE, SURELY, SURVEYS, SURPRISED
PAR - PARTIES, PARTS, PARTNERS, PARENTS, PARTNER, PARTIAL, PARAMETERS
BRI - BRING, BRIAN, BRINGS, BRITAIN, BRITNEY, BRIDGE, BRIDE
CON - CONTENT, CONTENTS, CONTINUE, CONNECT, CONTAINS, CONTEXT, CONTACTS
PRO - PROVIDES, PROJECTS, PROVIDE, PROJECT, PROCESS, PROFILE, PROPERTIES
ADV - ADVERTISE, ADVISE, ADVERSE, ADVERTISER, ADVERTISERS, ADVANCES, ADVERT
CAR - CARRIER, CARTER, CARRIERS, CARRIED, CAREER, CARRY, CAREERS
SUP - SUPPLIER, SUPPLIERS, SUPPORTS, SUPPORT, SUPPLIES, SUPPORTERS, SUPER
PLA - PLANE, PLANET, PLANS, PLATE, PLANT, PLANTS, PLAIN
EXP - EXPERIENCE, EXPERIENCED, EXPRESS, EXPERTS, EXPERIENCES, EXPENSES, EXPERT
COM - COMMENT, COMMENTS, COMES, COMPANIES, COMPLETE, COMPUTERS, COMMUNITIES
IMP - IMPORTED, IMPORTS, IMPORT, IMPROVEMENT, IMPROVE, IMPOSED, IMPROVED
GRA - GRADE, GRANDE, GRAND, GRANT, GRADES, GRANTS, GRAIN
FOR - FORMAT, FORMS, FORMED, FORMER, FOREST, FORMATS, FORCE
POS - POSTS, POSTINGS, POSTING, POSTERS, POSTER, POSTED, POSITIONS
WOR - WORKS, WORDS, WORSE, WORLDS, WORKERS, WORKED, WORST
ACC - ACCEPTED, ACCEPT, ACCESSED, ACCIDENT, ACCIDENTS, ACCOUNTS, ACCESS
APP - APPLE, APPLIED, APPEAL, APPAREL, APPEAR, APPLIANCES, APPEARED
MON - MONTE, MONITOR, MONETARY, MONSTER, MONTH, MONTREAL, MONITORS
COU - COUNTS, COUNTERS, COUNT, COUNTIES, COUNTER, COUNTRIES, COURTS
EXC - EXCEL, EXCEPT, EXCUSE, EXCLUDE, EXCEED, EXCERPT, EXCEPTION
BRO - BROKE, BROWSE, BROKER, BROKEN, BROKERS, BROWSER, BROWSERS
COL - COLLECTOR, COLLECTIONS, COLLECT, COLLECTION, COLLECTED, COLORS, COLLEGES
