PRO - PROVIDES, PROJECTS, PROBLEMS, PROVIDE, PROJECT
CON - CONTENT, CONTACTS, CONTENTS, CONTRACT, CONTEXT
COM - COMMENT, COMES, COMPARE, COMMENTS, COMPARED
THE - THERE, THEATRE, THEME, THEIR, THEATER
STA - STATE, START, STATS, STATES, STATED
RES - RESORT, RESOURCE, RESERVE, RESORTS, RESPECT
PRI - PRINTER, PRINT, PRINTERS, PRINTS, PRINTED
INT - INTER, INTERNET, INTERNAL, INTEL, INTEGER
TRA - TRAIN, TRAIL, TRANS, TRADING, TRAILER
SHO - SHOWS, SHOES, SHOPS, SHOWER, SHOWN
WOR - WORKS, WORDS, WORSE, WORLDS, WORST
PAR - PARTS, PARTIES, PARENTS, PARIS, PARENT
COU - COUNTS, COUNT, COUNTER, COURTS, COUNTIES
CHA - CHANGE, CHARGE, CHANGES, CHARGES, CHANGED
FOR - FOREST, FORMS, FORCE, FORMER, FORCES
PLA - PLANET, PLATE, PLACE, PLANT, PLACES
PRE - PRESENT, PRESENTS, PREVENT, PRESS, PRESSURE
DIS - DISASTER, DISEASE, DISTANCE, DISEASES, DISPUTE
POS - POSTS, POSTER, POSTERS, POSTING, POSTED
REA - READS, READY, READING, REACHED, READER
PER - PERSON, PERMITS, PERIOD, PERMIT, PERIODS
CAR - CARTER, CAREER, CARRY, CARRIER, CAREERS
FIN - FINDS, FINDER, FINGERS, FINGER, FINDINGS
REC - RECEIVE, RECEIVER, RECEIVED, RECIPE, RECEIVES
REP - REPLIED, REPLIES, REPLACE, REPAIR, REPLACED
STO - STORE, STORES, STORED, STORIES, STONE
APP - APPEAL, APPLE, APPEAR, APPEALS, APPAREL
IND - INDIE, INDICES, INDIA, INDICATE, INDEX
HEA - HEART, HEARD, HEADER, HEADS, HEADING
MAR - MARIE, MARINE, MARKET, MARIA, MARRIED
SPE - SPECIES, SPECS, SPECIAL, SPEAK, SPECIALS
COL - COLOUR, COLOR, COLORS, COLUMNS, COLUMN
EXP - EXPERT, EXPENSE, EXPERTS, EXPOSED, EXPLORE
REL - RELATE, RELATED, RELEASE, RELATIVE, RELEASED
LEA - LEASE, LEADER, LEADERS, LEARN, LEAVES
STR - STRING, STRANGE, STRINGS, STRENGTH, STRONG
MON - MONETARY, MONTH, MONEY, MONTREAL, MONITOR
ASS - ASSUME, ASSUMES, ASSET, ASSUMED, ASSETS
GEN - GENES, GENRE, GENRES, GENERIC, GENESIS
CHE - CHECKS, CHEAT, CHECK, CHEATS, CHEST
MIN - MINISTER, MINUTE, MINUS, MINUTES, MINISTRY
SHA - SHARE, SHARED, SHAPE, SHARES, SHAPED
BRO - BROKE, BROKER, BROKEN, BROWSE, BROWSER
GRA - GRAND, GRANT, GRANTS, GRAIN, GRADE
BLO - BLOGS, BLOOD, BLOCK, BLOCKS, BLOCKING
HAR - HARRY, HARDER, HARBOR, HARPER, HARRIS
SUR - SURVEY, SURELY, SURREY, SURVEYS, SURVIVE
REF - REFER, REFERS, REFUSE, REFUSED, REFINE
REM - REMAINED, REMAIN, REMOVE, REMOVED, REMAINS
BRI - BRING, BRIAN, BRINGS, BRITAIN, BRIDGE
CLO - CLOSE, CLOSED, CLOSER, CLOUDS, CLONE
FLO - FLOOR, FLOORS, FLORIST, FLORIDA, FLOWER
BEL - BELIEF, BELIEFS, BELIZE, BELIEVE, BELIEVES
HAN - HANDLE, HANDS, HANDED, HANDLES, HANDLED
TRI - TRIES, TRIBE, TRIED, TRIAL, TRIPLE
BRA - BRAND, BRANDS, BRAKE, BRAKES, BRAIN
