THE - THEMSELVES, THERAPEUTIC, THESIS, THEORETICAL, THEFT, THERAPY, THERMAL
RES - RESIDENTIAL, RESEARCH, RESULTING, RESERVED, RESPONSIBLE, RESOLUTION, RESTAURANT
INT - INTELLECTUAL, INTRODUCTION, INTELLIGENCE, INTRODUCED, INTEL, INTENDED, INTERRACIAL
STA - STAFF, STATISTICS, STANDARD, STANDING, STANDARDS, STATEMENT, STAGE
HEA - HEADQUARTERS, HEALTHCARE, HEAVILY, HEAVY, HEALING, HEALTHY, HEAVEN
DES - DESKTOPS, DESKTOP, DESTROY, DESTINATIONS, DESTRUCTION, DESTINATION, DESERT
INS - INSIDER, INSIGHT, INSURANCE, INSIDE, INSTALLED, INSPECTION, INSTALL
DIS - DISTRIBUTION, DISABILITY, DISTRIBUTED, DISTRICT, DISPLAY, DISPLAYED, DISABLED
REA - REASONABLE, REASONABLY, REALISTIC, REALLY, READER, REACHED, REACH
ASS - ASSEMBLY, ASSOCIATION, ASSOCIATIONS, ASSURANCE, ASSESSMENT, ASSAULT, ASSUMED
IND - INDEPENDENCE, INDOOR, INDEPENDENT, INDIANAPOLIS, INDUSTRY, INDIVIDUALS, INDIVIDUAL
TRA - TRACKBACK, TRAVEL, TRADEMARKS, TRADEMARK, TRANSPORT, TRANSMISSION, TRAFFIC
STR - STRUCTURAL, STRONGLY, STRUCTURES, STRIP, STRUCTURE, STREAM, STRETCH
FIN - FINALLY, FINDLAW, FINANCIAL, FINGERING, FINISHING, FINLAND, FINAL
SPE - SPENDING, SPECTRUM, SPECIFICALLY, SPEND, SPENT, SPEAKING, SPEAKERS
ATT - ATTITUDE, ATTRIBUTE, ATTRIBUTES, ATTENDING, ATTEMPT, ATTEMPTS, ATTORNEYS
REL - RELIGIOUS, RELIABILITY, RELIGION, RELATIONSHIP, RELIEF, RELIABLE, RELEVANT
SHA - SHANGHAI, SHAKESPEARE, SHAREHOLDERS, SHARING, SHAFT, SHALL, SHADOWS
TRI - TRIPADVISOR, TRIUMPH, TRINITY, TRINIDAD, TRIGGER, TRICK, TRICKS
GEN - GENUINE, GENEALOGY, GENOME, GENERALLY, GENTLE, GENESIS, GENETICS
PRE - PREGNANCY, PREMIUM, PREVIOUSLY, PRESCRIPTION, PRETTY, PREPARED, PREPARATION
PRI - PRIMARILY, PRIORITY, PRIVACY, PRIMARY, PRIOR, PRINTING, PRINCIPAL
PER - PERSPECTIVE, PERHAPS, PERCENTAGE, PERFECT, PERMITTED, PERMALINK, PERCENT
MIN - MINNEAPOLIS, MINING, MINIMUM, MINIMIZE, MINOLTA, MINIMAL, MINNESOTA
REG - REGIME, REGARDLESS, REGISTRATION, REGGAE, REGULARLY, REGION, REGISTERED
REC - RECOGNITION, RECRUITMENT, RECENTLY, RECORDS, RECREATION, RECEIVING, RECOMMENDED
REP - REPRODUCTION, REPLY, REPUBLICAN, REPUBLIC, REPUTATION, REPLACED, REPLACEMENT
INC - INCORPORATED, INCLUDING, INCORPORATE, INCLUSION, INCORRECT, INCREASINGLY, INCENTIVES
CHE - CHECKING, CHEVROLET, CHERRY, CHECKOUT, CHEMICAL, CHEMISTRY, CHECKED
INV - INVALID, INVOLVING, INVITATION, INVOICE, INVENTORY, INVOLVED, INVOLVEMENT
REF - REFORM, REFURBISHED, REFINANCE, REFORMS, REFLECTION, REFUND, REFERRAL
SHO - SHOPPING, SHOOTING, SHOULD, SHOULDER, SHOCK, SHOWING, SHOWCASE
REM - REMEMBERED, REMARKABLE, REMEMBER, REMAINING, REMARKS, REMOVAL, REMIX
SUB - SUBSEQUENTLY, SUBSIDIARY, SUBLIME, SUBJECT, SUBJECTS, SUBCOMMITTEE, SUBSTANTIAL
CHA - CHANGING, CHAIRMAN, CHARACTER, CHAPTER, CHARACTERS, CHALLENGE, CHALLENGES
MAR - MARSHALL, MARYLAND, MARKETPLACE, MARCH, MARRIOTT, MARGARET, MARKS
HAR - HARASSMENT, HARMFUL, HARDWOOD, HARVEST, HARRISON, HARMONY, HARDWARE
SUR - SURROUNDING, SURGICAL, SURPLUS, SURVIVOR, SURVEILLANCE, SURROUND, SURPRISING
PAR - PARAGRAPH, PARALLEL, PARKING, PARTICULARLY, PARKS, PARTNERSHIP, PARTICIPATE
BRI - BRITANNICA, BRILLIANT, BRICK, BRISTOL, BRITISH, BRIEFLY, BRIDAL
CON - CONGRESS, CONSIDERED, CONFERENCE, CONSUMER, CONSIDER, CONTROL, CONDITIONS
PRO - PROBABLY, PROFESSIONAL, PROVIDING, PROGRAM, PROGRAMME, PRODUCTION, PROGRAMS
ADV - ADVOCACY, ADVERTISING, ADVANTAGE, ADVISORY, ADVANCED, ADVANTAGES, ADVISORS
CAR - CAREFULLY, CARIBBEAN, CAROLINA, CARTOONS, CAREFUL, CARTOON, CARBON
SUP - SUPERVISION, SUPPLEMENTAL, SUPERVISOR, SUPPLY, SUPREME, SUPPORTING, SUPERIOR
PLA - PLATFORM, PLAYSTATION, PLANNING, PLASMA, PLASTIC, PLAYING, PLACED
EXP - EXPANSION, EXPAND, EXPLAIN, EXPERIMENTAL, EXPOSURE, EXPORT, EXPENSIVE
COM - COMMISSION, COMMERCIAL, COMING, COMPANY, COMPLEX, COMMAND, COMMITTEE
IMP - IMPLICATIONS, IMPERIAL, IMPLEMENTING, IMPOSSIBLE, IMPACT, IMPACTS, IMPLIED
GRA - GRAMMAR, GRADUATION, GRAVITY, GRAPHICS, GRAPHIC, GRAHAM, GRAPH
FOR - FORWARD, FOREVER, FOREIGN, FORMATION, FORGOT, FORMULA, FORTH
POS - POSSIBILITY, POSSIBLY, POSSESSION, POSSESS, POSTCARD, POSITIONING, POSTPOSTED
WOR - WORLDWIDE, WORKING, WORKFORCE, WORTHY, WORKPLACE, WORDPRESS, WORRY
ACC - ACCURACY, ACCORDINGLY, ACCOUNTING, ACCEPTABLE, ACCESSIBLE, ACCORDING, ACCESSORY
APP - APPENDIX, APPOINTMENT, APPLICATIONS, APPROACH, APPLICATION, APPLY, APPROACHES
MON - MONGOLIA, MONICA, MONITORING, MONACO, MONDAY, MONKEY, MONTANA
COU - COUNSELING, COULD, COUNCIL, COUPLE, COUPON, COUPLES, COURSES
EXC - EXCITING, EXCHANGES, EXCLUSIVELY, EXCEPTIONAL, EXCELLENCE, EXCHANGE, EXCLUDING
BRO - BROUGHT, BROADBAND, BROADCASTING, BROOKLYN, BROCHURE, BROADWAY, BROADCAST
COL - COLORADO, COLUMBUS, COLUMBIA, COLOMBIA, COLUMN, COLUMNS, COLORED
