ING - USING, SHIPPING, BEING, FOLLOWING, INCLUDING, RATING, DURING, SHOPPING, LISTING, TRAINING
ION - INFORMATION, EDUCATION, VERSION, SECTION, LOCATION, DESCRIPTION, ACTION, APPLICATION, QUESTION, MILLION
ENT - MANAGEMENT, DEVELOPMENT, CURRENT, GOVERNMENT, DEPARTMENT, CONTENT, DIFFERENT, COMMENT, PAYMENT, EQUIPMENT
PRO - PRODUCTS, PRODUCT, PROGRAM, PROJECT, PROFILE, PROPERTY, PROVIDE, PROCESS, PROVIDED, PROGRAMS
CON - CONTACT, CONTROL, CONTENT, CONDITIONS, CONFERENCE, CONSTRUCTION, CONTENTS, CONTINUE, CONDITION, CONSUMER
COM - COMPANY, COMMENTS, COMMUNITY, COMPUTER, COMPARE, COME, COMPLETE, COMMENT, COMMITTEE, COMPANIES
THE - THEY, THEIR, THERE, THESE, THEM, THEN, THEREFORE, THEORY, THEMSELVES, THERAPY
THI - THIS, THINK, THINGS, THING, THIRD, THINKING, THIN, THICK, THIRTY, THINKS
TED - UNITED, POSTED, RELATED, LISTED, UPDATED, LIMITED, CREATED, STARTED, LOCATED, ASSOCIATED
ERS - MEMBERS, USERS, OFFERS, COMPUTERS, OTHERS, CUSTOMERS, ORDERS, PLAYERS, SELLERS, NUMBERS
TER - AFTER, CENTER, TERMS, COMPUTER, WATER, REGISTER, BETTER, ENTER, TERM, NEWSLETTER
ONS - CONDITIONS, QUESTIONS, OPTIONS, SOLUTIONS, APPLICATIONS, COMMUNICATIONS, OPERATIONS, PUBLICATIONS, LOCATIONS, RELATIONS
IES - MOVIES, CATEGORIES, SERIES, ACCESSORIES, ACTIVITIES, COMPANIES, STORIES, STUDIES, POLICIES, COUNTRIES
ATE - DATE, STATE, RATE, PRIVATE, ESTATE, CREATE, UPDATE, CORPORATE, APPROPRIATE, LATE
NCE - SINCE, INSURANCE, SCIENCE, PERFORMANCE, EXPERIENCE, REFERENCE, ONCE, FRANCE, CONFERENCE, FINANCE
AGE - PAGE, MESSAGE, IMAGE, LANGUAGE, AVERAGE, STORAGE, AGENCY, PACKAGE, MORTGAGE, HOMEPAGE
ITY - CITY, UNIVERSITY, COMMUNITY, SECURITY, QUALITY, AVAILABILITY, ACTIVITY, OPPORTUNITY, AUTHORITY, RESPONSIBILITY
STA - STATE, STATES, START, STAFF, STANDARD, STATUS, STAR, STATEMENT, STANDARDS, STAY
ORE - MORE, STORE, BEFORE, SCORE, THEREFORE, CORE, HARDCORE, OREGON, EXPLORE, SINGAPORE
NTS - COMMENTS, STUDENTS, EVENTS, REQUIREMENTS, POINTS, CONTENTS, DOCUMENTS, PARENTS, PATIENTS, RESTAURANTS
RES - RESEARCH, RESULTS, RESERVED, RESOURCES, PICTURES, FEATURES, STORES, RESULT, RESOURCE, RESPONSE
OUR - YOUR, FOUR, TOUR, HOUR, COLOUR, LABOUR, POUR, BEHAVIOUR, OURSELVES, HARBOUR
OME - HOME, SOME, COME, BECOME, WELCOME, INCOME, ROME, AWESOME, SYNDROME, OUTCOME
ERE - THERE, HERE, WERE, WHERE, ANYWHERE, SEVERE, ELSEWHERE, ATMOSPHERE, SOMEWHERE, EVERYWHERE
ESS - BUSINESS, ADDRESS, ACCESS, PRESS, PROCESS, LESS, WIRELESS, EXPRESS, SUCCESS, FITNESS
HER - OTHER, HERE, ANOTHER, FURTHER, WHETHER, WEATHER, EITHER, TOGETHER, HIGHER, RATHER
PRI - PRICE, PRIVACY, PRICES, PRIVATE, PRINT, PRINTER, PRIMARY, PRIOR, PRICING, PRIME
INT - INTO, INTERNATIONAL, INTERNET, PRINT, POINT, INTEREST, INTRODUCTION, INTERFACE, INTERNAL, INTERESTED
NAL - INTERNATIONAL, NATIONAL, PERSONAL, ADDITIONAL, PROFESSIONAL, JOURNAL, ORIGINAL, FINAL, REGIONAL, ANAL
ICE - SERVICE, PRICE, OFFICE, NOTICE, PRACTICE, ADVICE, NICE, CHOICE, VOICE, POLICE
IVE - LIVE, GIVE, ARCHIVE, DRIVE, FIVE, RECEIVE, ACTIVE, EFFECTIVE, EXECUTIVE, POSITIVE
AVE - HAVE, SAVE, AVERAGE, LEAVE, GAVE, AVENUE, DAVE, WAVE, SLAVE, MICROWAVE
INE - ONLINE, LINE, MAGAZINE, ENGINE, FINE, MACHINE, MEDICINE, WINE, PHENTERMINE, DETERMINE
ILL - WILL, STILL, BILL, HILL, ILLINOIS, FILL, KILL, ILLEGAL, TILL, SKILL
TRA - TRAVEL, TRAINING, TRACK, TRADE, TRANSFER, EXTRA, TRAFFIC, TRANSPORTATION, TRADEMARKS, TRADITIONAL
EST - BEST, WEST, ESTATE, TEST, LATEST, REQUEST, INTEREST, GUEST, REST, INCEST
CES - SERVICES, PRICES, RESOURCES, SOURCES, PLACES, DEVICES, REFERENCES, SCIENCES, PRACTICES, FORCES
BLE - AVAILABLE, TABLE, POSSIBLE, ABLE, DOUBLE, CABLE, RESPONSIBLE, BIBLE, ENABLE, VARIABLE
SHO - SHOULD, SHOW, SHOP, SHOPPING, SHORT, SHOWS, SHOES, SHOWN, SHOWING, SHOT
ITE - SITE, ITEMS, ITEM, WEBSITE, WHITE, WRITE, FAVORITE, QUITE, SUITE, SATELLITE
MOR - MORE, MORTGAGE, MORNING, HUMOR, MORGAN, MORTGAGES, MORAL, MORRIS, MOREOVER, MOROCCO
WOR - WORLD, WORK, WORKING, WORD, WORKS, WORDS, WORLDWIDE, WORTH, WORKERS, WORKED
URE - PICTURE, FUTURE, SURE, FIGURE, NATURE, MATURE, CULTURE, FURNITURE, STRUCTURE, FEATURE
GHT - COPYRIGHT, RIGHT, NIGHT, LIGHT, MIGHT, WEIGHT, THOUGHT, BROUGHT, FLIGHT, EIGHT
SER - SERVICES, SERVICE, USER, SERIES, SERVER, BROWSER, SERVERS, SERIOUS, SERVE, LASER
VER - OVER, VERY, VERSION, HOWEVER, SERVER, NEVER, EVER, COVER, RIVER, SILVER
PAR - PART, PARTY, PARK, PARTS, PARTICULAR, PARENTS, PARTNERS, PARTNER, PARTIES, PARIS
COU - COULD, COUNTY, COUNTRY, COURSE, COURT, COUNCIL, COUNTRIES, COURSES, COUPLE, COUNT
CHA - CHANGE, CHANGES, CHAPTER, CHAT, CHANNEL, CHARGE, CHARACTER, CHANGED, CHARLES, CHANCE
WIL - WILL, WILLIAM, WILD, WILLIAMS, WILSON, WILDLIFE, WILLING, WILDERNESS, WILLOW, WILEY
OUT - ABOUT, WITHOUT, OUTSIDE, OUTPUT, OUTDOOR, THROUGHOUT, CHECKOUT, OUTDOORS, OUTLET, OUTSTANDING
FOR - FORUM, FORM, FORUMS, FORMAT, FORCE, FOREIGN, FORMS, FORWARD, FORMER, FOREST
PLA - PLACE, PLAN, PLAY, PLANNING, PLAYER, PLAYERS, PLANS, PLANT, PLACES, PLAYING
PRE - PREVIOUS, PRESS, PRESIDENT, PRESENT, PREV, PRETTY, PRESSURE, PRESENTED, PREMIUM, PRESENTATION
TES - STATES, SITES, TEST, RATES, MINUTES, NOTES, TESTING, ASSOCIATES, UPDATES, QUOTES
INF - INFORMATION, INFO, INFORMED, INFRASTRUCTURE, INFLUENCE, INFECTION, INFANT, INFORM, INFORMATIONAL, INFLATION
BER - NUMBER, MEMBER, DECEMBER, OCTOBER, NOVEMBER, SEPTEMBER, REMEMBER, CHAMBER, BERLIN, RUBBER
ARY - JANUARY, LIBRARY, FEBRUARY, SUMMARY, NECESSARY, MILITARY, PRIMARY, MARY, SECRETARY, DICTIONARY
DIS - DISCUSSION, DISPLAY, DISTRICT, DISCOUNT, DISTRIBUTION, DISEASE, DISTANCE, DISCLAIMER, DISCUSS, DISC
LES - SALES, ARTICLES, LESS, FILES, MILES, RULES, LESBIAN, ANGELES, TITLES, CHARLES
IAL - SPECIAL, FINANCIAL, SOCIAL, OFFICIAL, MATERIAL, COMMERCIAL, INDUSTRIAL, POTENTIAL, TRIAL, INITIAL
POS - POST, POSTED, POSTS, POSSIBLE, POSITION, POSITIVE, POSTER, POSTERS, POSTAL, POSTING
REA - READ, REAL, AREA, REALLY, READING, REASON, READY, READER, REASONS, REACH
PER - PERSONAL, PERSON, PERFORMANCE, PAPER, PERIOD, PERCENT, SUPER, PERFECT, PERHAPS, PERSONS
SEA - SEARCH, SEASON, SEARCHES, SEATTLE, SEAT, SEARCHING, SEATS, SEAL, SEAN, SEALED
SED - USED, BASED, PROPOSED, RELEASED, INCREASED, CLOSED, PASSED, CAUSED, REVISED, LICENSED
CAR - CARE, CARD, CART, CARDS, CARS, CAREER, CAROLINA, CAREERS, CARRY, CARRIED
CAL - LOCAL, CALL, MEDICAL, CALIFORNIA, CALLED, TECHNICAL, CALENDAR, POLITICAL, PHYSICAL, CRITICAL
RED - REQUIRED, POWERED, REGISTERED, SPONSORED, FEATURED, CONSIDERED, OFFERED, REDUCE, COVERED, COMPARED
EEN - BEEN, BETWEEN, TEEN, GREEN, SEEN, SCREEN, QUEEN, HALLOWEEN, WIDESCREEN, FIFTEEN
ORT - SUPPORT, REPORT, SHORT, SORT, PORT, AIRPORT, SPORT, TRANSPORT, RESORT, EFFORT
AND - HAND, LAND, ISLAND, BRAND, ENGLAND, BAND, UNDERSTAND, COMMAND, IRELAND, GRAND
ECT - SUBJECT, PROJECT, SELECT, DIRECT, EFFECT, OBJECT, PERFECT, RESPECT, CONNECT, CORRECT
FRE - FREE, FRENCH, FREEDOM, FRESH, FREQUENTLY, FREQUENCY, FRED, FREEWARE, FREQUENT, FREIGHT
DER - ORDER, UNDER, CONSIDER, READER, OLDER, PROVIDER, LEADER, GENDER, BORDER, WONDER
ACK - BACK, BLACK, FEEDBACK, TRACK, PACK, JACK, PAPERBACK, ATTACK, LACK, TRACKBACK
ARE - SOFTWARE, AREA, CARE, COMPARE, AREAS, SHARE, HARDWARE, SQUARE, RARE, HEALTHCARE
ASE - PLEASE, CASE, RELEASE, DATABASE, PURCHASE, INCREASE, BASE, DISEASE, PHASE, LEASE
FIN - FIND, FINANCIAL, FINAL, FINANCE, FINE, FINALLY, FINDING, FINISH, FINISHED, FINANCING
ACC - ACCESS, ACCOUNT, ACCESSORIES, ACCORDING, ACCOMMODATION, ACCEPTED, ACCEPT, ACCOUNTS, ACCOUNTING, ACCEPTANCE
REC - RECENT, RECORD, RECORDS, RECEIVED, RECEIVE, RECENTLY, RECOMMENDED, RECOMMEND, RECOVERY, RECOMMENDATIONS
REP - REPORT, REPLY, REPORTS, REPUBLIC, REPORTED, REPAIR, REPLIES, REPORTING, REPLACEMENT, REPRESENTATIVE
STO - STORE, STOCK, STORES, STORY, STORIES, STORAGE, STOP, STONE, STORM, STOCKS
APP - APPLICATION, APPLICATIONS, APPLY, APPROPRIATE, APPROACH, APPROVED, APPLE, APPLIED, APPEAR, APPAREL
ORY - HISTORY, DIRECTORY, CATEGORY, MEMORY, STORY, THEORY, LABORATORY, FACTORY, ADVISORY, INVENTORY
AME - NAME, SAME, AMERICAN, GAME, AMERICA, CAME, FRAME, USERNAME, BECAME, AMENDMENT
IND - FIND, INDEX, INDUSTRY, INDIVIDUAL, INDIA, MIND, KIND, INDUSTRIAL, INDEPENDENT, INDIAN
AST - LAST, EAST, LEAST, PAST, FAST, COAST, BREAST, BREAKFAST, CAST, FORECAST
ALL - SMALL, CALL, SHALL, OVERALL, ALLOW, FALL, HALL, WALL, FOOTBALL, ALLOWS
SIT - SITE, SITES, VISIT, SITUATION, SITEMAP, TRANSIT, DEPOSIT, SITTING, SITUATIONS, SITUATED
LIN - LINKS, LINE, LINK, LINUX, LINES, LINGERIE, LINEAR, LINKED, LINCOLN, BERLIN
HEA - HEALTH, HEAD, HEART, HEAR, HEARD, HEAT, HEARING, HEAVY, HEADLINES, HEALTHY
ARD - BOARD, CARD, STANDARD, HARD, AWARD, FORWARD, RICHARD, HEARD, TOWARD, EDWARD
MAN - MANY, MANAGEMENT, HUMAN, MANAGER, WOMAN, MANUFACTURER, GERMAN, MANUAL, MANUFACTURING, MANAGE
HEN - WHEN, THEN, KITCHEN, HENTAI, HENRY, STEPHEN, HENCE, HENDERSON, STRENGTHEN, COHEN
INC - INCLUDING, INCLUDE, INCLUDES, INCLUDED, INCREASE, INCOME, INCEST, INCREASED, INCH, INCREASING
AIN - MAIN, AGAIN, DOMAIN, CERTAIN, MOUNTAIN, SPAIN, PAIN, CHAIN, BRAIN, MAINTAIN
ERY - VERY, EVERY, GALLERY, DELIVERY, BATTERY, SURGERY, RECOVERY, QUERY, DISCOVERY, MYSTERY
EVE - EVEN, EVENTS, EVERY, EVENT, EVER, EVERYTHING, BELIEVE, EVERYONE, STEVE, EVENING
IME - TIME, CRIME, PRIME, ANIME, ANYTIME, SUBLIME, LIFETIME, DEALTIME, REGIME, MARITIME
MAR - MARKET, MARCH, MARKETING, MARK, MARY, MARTIN, MARKETS, MARINE, MARYLAND, MARRIAGE
SPE - SPECIAL, SPECIFIC, SPEED, SPECIFIED, SPECIES, SPECIFICATIONS, SPEAK, SPEECH, SPEAKER, SPENT
DES - DESIGN, DESCRIPTION, INCLUDES, PROVIDES, DESIGNED, GUIDES, DESKTOP, DESCRIBED, DESIGNATED, CODES
UNI - UNIVERSITY, UNITED, UNIT, UNION, UNIQUE, UNITS, UNIVERSAL, UNIX, UNIVERSE, UNIVERSITIES
TAL - TOTAL, DIGITAL, TALK, ENVIRONMENTAL, RENTAL, CAPITAL, HOSPITAL, METAL, TALKING, MENTAL
LLY - REALLY, USUALLY, ACTUALLY, ESPECIALLY, FINALLY, FULLY, GENERALLY, AUTOMATICALLY, KELLY, ORIGINALLY
RAL - GENERAL, CENTRAL, SEVERAL, NATURAL, FEDERAL, CULTURAL, ORAL, RURAL, AGRICULTURAL, LIBERAL
ANT - WANT, IMPORTANT, ANTI, SIGNIFICANT, PLANT, RESTAURANT, GRANT, RELEVANT, MERCHANT, ASSISTANT
USE - USED, USER, BECAUSE, HOUSE, USERS, CAUSE, USEFUL, USES, USERNAME, ABUSE
MES - MESSAGE, GAMES, TIMES, MESSAGES, JAMES, NAMES, HOMES, COMES, SOMETIMES, BECOMES
IDE - GUIDE, PROVIDE, SIDE, WIDE, INSIDE, OUTSIDE, IDEAS, IDEA, WORLDWIDE, IDENTIFY
NEW - NEWS, NEWSLETTER, NEWSLETTERS, KNEW, NEWSPAPER, NEWEST, NEWLY, NEWSPAPERS, NEWTON, NEWPORT
INS - INSURANCE, INSTITUTE, INSIDE, INSTEAD, CONTAINS, INSTRUCTIONS, INSTRUMENTS, INSTALLATION, INSTALL, INSTITUTIONS
LIS - LIST, LISTING, LISTED, LISTINGS, LISTS, LISTEN, LISTENING, CIALIS, LISA, MINNEAPOLIS
PLE - PEOPLE, PLEASE, EXAMPLE, SIMPLE, SAMPLE, MULTIPLE, APPLE, COUPLE, PLEASURE, PRINCIPLE
ACT - CONTACT, ACTION, ACTIVITIES, FACT, ACTIVE, ACTIVITY, ACTUALLY, CONTRACT, IMPACT, ABSTRACT
COL - COLLEGE, COLOR, COLLECTION, COLUMBIA, COLORADO, COLD, COLUMN, PROTOCOL, COLLECTIBLES, COLOUR
EXP - EXPERIENCE, EXPRESS, EXPECTED, EXPERT, EXPECT, EXPERTS, EXPLORE, EXPRESSION, EXPOSURE, EXPLAIN
SEC - SECTION, SECURITY, SECOND, SECURE, SECTOR, SECRETARY, SECTIONS, SECONDS, SECRET, SECONDARY
AIL - EMAIL, MAIL, RETAIL, DETAIL, FAIL, TRAIL, RAIL, THUMBNAIL, TAIL, NAIL
ONE - PHONE, DONE, NONE, SOMEONE, ANYONE, EVERYONE, TELEPHONE, ZONE, STONE, ALONE
REL - RELATED, RELEASE, RELEASES, RELATIONS, RELEASED, RELATIONSHIP, RELEVANT, APPAREL, RELIGION, RELIGIOUS
EAR - YEAR, EARLY, CLEAR, NEAR, EARTH, HEAR, GEAR, APPEAR, EARLIER, NUCLEAR
SES - CASES, COURSES, RELEASES, USES, SESSION, PURPOSES, CLASSES, BUSINESSES, PROCESSES, HOUSES
LEA - LEARN, LEARNING, LEAST, LEAVE, LEAD, LEADING, LEATHER, LEAGUE, LEADER, LEADERSHIP
OFF - OFFICE, OFFERS, OFFER, OFFICIAL, OFFERED, OFFICER, OFFERING, OFFICES, OFFICIALS, OFFICERS
THR - THROUGH, THREE, THREAD, THROUGHOUT, THREADS, THREAT, THROW, THROAT, THRESHOLD, THRU
DAY - DAYS, TODAY, FRIDAY, HOLIDAY, MONDAY, SUNDAY, TUESDAY, SATURDAY, THURSDAY, WEDNESDAY
GES - PAGES, CHANGES, IMAGES, MESSAGES, PACKAGES, LANGUAGES, CHARGES, AGES, COLLEGES, CHALLENGES
ILE - FILE, WHILE, PROFILE, MOBILE, MILE, CHILE, SMILE, AUTOMOBILE, JUVENILE, TILE
RTS - SPORTS, REPORTS, ARTS, PARTS, EFFORTS, SHIRTS, EXPERTS, SUPPORTS, CHARTS, STARTS
SUP - SUPPORT, SUPPLIES, SUPPLY, SUPER, SUPPORTED, SUPPLIED, SUPPORTS, SUPPLIERS, SUPPORTING, SUPPLIER
CTS - PRODUCTS, PROJECTS, EFFECTS, SUBJECTS, FACTS, CONTACTS, OBJECTS, ASPECTS, CONTRACTS, ACTS
ELL - WELL, SELL, CELL, TELL, DELL, BELL, HELL, SHELL, RUSSELL, FELL
STR - STREET, STRUCTURE, STRONG, STRATEGY, STRING, STREAM, STRATEGIES, STRAIGHT, STRATEGIC, STRENGTH
HEL - HELP, HELD, HELPFUL, HELLO, HELPS, HELPING, HELL, HELPED, RACHEL, HELEN
DED - PROVIDED, ADDED, INCLUDED, NEEDED, RECOMMENDED, INTENDED, EXTENDED, DEDICATED, DECIDED, ENDED
AKE - MAKE, TAKE, LAKE, CAKE, WAKE, BUKKAKE, MISTAKE, FAKE, BRAKE, INTAKE
REV - REVIEW, REVIEWS, PREV, REVENUE, REVIEWED, REVISED, REVISION, REVOLUTION, REVERSE, REVENUES
BOO - BOOKS, BOOK, BOOKMARK, BOOKING, BOOBS, BOOT, BOOTS, BOOTY, BOOST, BOOKSTORE
NGS - THINGS, LISTINGS, RATINGS, SONGS, SETTINGS, MEETINGS, SAVINGS, SPRINGS, RINGS, BUILDINGS
MUS - MUSIC, MUST, MUSEUM, MUSICAL, MUSCLE, MUSLIM, MUSEUMS, MUSICIANS, MUSLIMS, MUSICIAN
SOM - SOME, SOMETHING, SOMEONE, SOMETIMES, SOMEWHAT, SOMEWHERE, SOMEBODY, SOMEHOW, SOMA, SOMERSET
PHO - PHONE, PHOTO, PHOTOS, PHONES, PHOTOGRAPHY, PHOENIX, PHOTOGRAPHS, PHOTOGRAPHER, PHOTOGRAPH, PHOTOSHOP
CLI - CLICK, CLIENT, CLIENTS, CLINICAL, CLIPS, CLIP, CLIMATE, CLICKING, CLINTON, CLINIC
ICS - ELECTRONICS, TOPICS, LYRICS, PICS, STATISTICS, GRAPHICS, POLITICS, ECONOMICS, COMICS, PHYSICS
REG - REGISTER, REGION, REGISTERED, REGIONAL, REGISTRATION, REGULAR, REGARDING, REGULATIONS, REGULATION, REGIONS
EAD - READ, THREAD, HEAD, LEAD, INSTEAD, DEAD, AHEAD, SPREAD, BREAD, OVERHEAD
UND - UNDER, FOUND, AROUND, SOUND, FUND, ROUND, UNDERSTAND, GROUND, BACKGROUND, UNDERSTANDING
ICK - CLICK, QUICK, PICK, DICK, STICK, PATRICK, NICK, SICK, THICK, RICK
ART - PART, ARTICLE, START, CART, ARTICLES, ARTS, HEART, ARTIST, ARTISTS, SMART
NDS - FRIENDS, ISLANDS, FUNDS, BRANDS, HANDS, SECONDS, THOUSANDS, KINDS, ENDS, SOUNDS
STU - STUDENTS, STUDY, STUDENT, STUDIES, STUFF, STUDIO, STUDIOS, STUPID, STUDIED, STUDYING
POL - POLICY, POLICIES, POLITICAL, POLICE, POLITICS, POLL, POLLS, POLAND, POLLUTION, POLISH
SEL - SELECT, SELL, SELLER, SELF, SELECTION, SELLERS, SELECTED, SELLING, COUNSEL, DIESEL
TOR - DIRECTOR, EDITOR, SECTOR, MONITOR, MOTOR, DOCTOR, FACTOR, TORONTO, ADMINISTRATOR, OPERATOR
SUB - SUBJECT, SUBSCRIBE, SUBMIT, SUBMITTED, SUBJECTS, SUBSCRIPTION, SUBMISSION, SUBSCRIPTIONS, SUBSTANCE, SUBSTANCES
NED - DESIGNED, JOINED, DEFINED, SIGNED, OWNED, DETERMINED, TURNED, RETURNED, OBTAINED, CONTAINED
ACE - PLACE, SPACE, FACE, INTERFACE, RACE, SURFACE, PEACE, MARKETPLACE, REPLACE, GRACE
IST - LIST, ARTIST, ASSIST, CHRIST, EXIST, SPECIALIST, HIST, TOURIST, WISHLIST, FLORIST
VIE - VIEW, MOVIE, VIEWS, VIEWED, VIEWING, VIETNAM, VIEWER, VIENNA, VIEWPICTURE, VIETNAMESE
RAT - RATING, RATE, RATES, RATHER, RATINGS, RATED, RATIO, RATS, RATIONAL, DEMOCRAT
VED - RESERVED, RECEIVED, INVOLVED, APPROVED, MOVED, SERVED, REMOVED, IMPROVED, OBSERVED, LOVED
OOD - GOOD, FOOD, BLOOD, WOOD, NEIGHBORHOOD, HOLLYWOOD, FLOOD, CHILDHOOD, UNDERSTOOD, MOOD
MON - MONEY, MONTH, MONTHS, COMMON, MONDAY, MONTHLY, MONITOR, MONITORING, MONTANA, SIMON
FIR - FIRST, FIRE, FIRM, FIRMS, FIREFOX, FIREWALL, FIRED, FIRES, FIREWIRE, FIREPLACE
MAI - MAIL, MAIN, MAILING, MAINTENANCE, MAINTAIN, MAINTAINED, MAINE, MAINLY, MAINTAINING, MAINLAND
ALS - ALSO, DEALS, MATERIALS, RENTALS, ANIMALS, INDIVIDUALS, GOALS, PROFESSIONALS, OFFICIALS, SPECIALS
MEM - MEMBER, MEMBERS, MEMORY, MEMBERSHIP, MEMORIAL, MEMORABILIA, MEMORIES, MEMPHIS, MEMBRANE, MEMO
STS - POSTS, COSTS, LISTS, ARTISTS, TESTS, INTERESTS, REQUESTS, GUESTS, EXISTS, BREASTS
SOU - SOUTH, SOURCE, SOUND, SOURCES, SOUTHERN, SOUL, SOUNDS, SOUTHWEST, SOUTHEAST, SOUGHT
OSE - THOSE, CLOSE, CHOOSE, PURPOSE, WHOSE, ROSE, LOSE, JOSE, DOSE, LOOSE
ANY - COMPANY, MANY, GERMANY, ANYTHING, ANYONE, ANYWAY, ANYWHERE, ANYTIME, TIFFANY, ALBANY
ASS - CLASS, ASSOCIATION, ASSOCIATED, GLASS, ASSESSMENT, PASS, ASSISTANCE, ASSOCIATES, MASS, ASSISTANT
ARS - YEARS, CARS, STARS, DOLLARS, APPEARS, BARS, WARS, BEARS, SEMINARS, MARS
PUB - PUBLIC, PUBLISHED, PUBLICATIONS, PUBLISHER, PUBLICATION, PUBLISHING, PUBMED, PUBLISHERS, PUBLISH, PUBLICLY
ADV - ADVANCED, ADVERTISING, ADVERTISE, ADVICE, ADVANCE, ADVENTURE, ADVERTISEMENT, ADVANTAGE, ADVISOR, ADVISORY
GRO - GROUP, GROUPS, GROWTH, GROUND, GROWING, GROW, GROSS, GROVE, GROWN, GROUNDS
AYS - DAYS, ALWAYS, SAYS, WAYS, HOLIDAYS, PLAYS, DISPLAYS, ESSAYS, PAYS, DELAYS
SON - PERSON, SONY, SEASON, SONG, REASON, SONGS, JOHNSON, COMPARISON, JACKSON, WILSON
FIL - FILE, FILES, FILM, FILTER, FILMS, FILL, FILED, FILLED, FILTERS, FILING
GEN - GENERAL, GENERALLY, GENERATION, GENERATED, GENE, GENDER, GENERIC, GENRE, GENERATE, GENETIC
CHI - CHILDREN, CHINA, CHILD, CHICAGO, CHINESE, CHIEF, CHICKEN, CHIP, CHILE, CHIPS
ADD - ADDRESS, ADDITIONAL, ADDED, ADDITION, ADDRESSES, ADDING, ADDRESSED, ADDS, ADDITIONS, ADDRESSING
OOK - BOOK, LOOK, TOOK, COOK, NOTEBOOK, OUTLOOK, HANDBOOK, GUESTBOOK, HOOK, EBOOK
DEV - DEVELOPMENT, DEVELOPED, DEVELOP, DEVICE, DEVICES, DEVELOPING, DEVELOPER, DEVEL, DEVELOPERS, DEVELOPMENTS
ORS - AUTHORS, VISITORS, FACTORS, ERRORS, DIRECTORS, COLORS, OUTDOORS, SPONSORS, EDITORS, DOORS
TEM - SYSTEM, ITEM, TEMPERATURE, TEMPLATE, TEMPORARY, TEMPLATES, TEMPLE, TEMP, STEM, TEMPERATURES
RDS - CARDS, RECORDS, WORDS, STANDARDS, BOARDS, KEYWORDS, AWARDS, TOWARDS, BIRDS, YARDS
BAS - BASED, BASIC, BASE, BASIS, BASKET, BASEBALL, BASKETBALL, BASS, BASKETS, BASICALLY
CHE - CHECK, CHEAP, CHEMICAL, CHECKOUT, CHEATS, CHEMISTRY, CHECKING, CHECKS, CACHE, CHEESE
LOC - LOCAL, LOCATION, LOCATED, LOCATIONS, LOCK, LOCATE, LOCKED, LOCATOR, LOCALLY, LOCALE
CEN - CENTER, CENTRAL, CENTRE, CENTURY, CENTERS, CENT, CENSUS, CENTRES, CENTS, CENTURIES
HOU - HOUSE, HOURS, HOUR, HOUSING, HOUSTON, HOUSES, HOUSEHOLD, THOU, HOUSEWARES, HOUSEHOLDS
ONG - LONG, ALONG, AMONG, SONG, STRONG, WRONG, KONG, HONG, ONGOING, BELONG
CRE - CREDIT, CREATE, CREATED, CREATIVE, CREATING, CREEK, CREDITS, CREATION, CREAM, CREW
END - SEND, FRIEND, ENDING, RECOMMEND, WEEKEND, ENDS, ENDED, SPEND, ATTEND, LEGEND
THO - THOSE, THOUGH, THOUGHT, THOMAS, THOUSANDS, THOUGHTS, THOUSAND, THONGS, THOMPSON, THOU
EXT - NEXT, TEXT, EXTRA, EXTERNAL, CONTEXT, EXTENDED, EXTENSION, EXTREME, EXTENT, EXTREMELY
NES - LINES, PHONES, MAGAZINES, GUIDELINES, RINGTONES, JONES, MACHINES, ONES, HEADLINES, ENGINES
ISH - ENGLISH, WISH, BRITISH, FISH, SPANISH, FINISH, IRISH, ESTABLISH, JEWISH, DISH
IAN - LESBIAN, ASIAN, CHRISTIAN, CANADIAN, INDIAN, AUSTRALIAN, RUSSIAN, ITALIAN, BRIAN, PHYSICIAN
DIR - DIRECTORY, DIRECTOR, DIRECT, DIRECTLY, DIRECTIONS, DIRECTION, DIRECTORS, DIRECTED, DIRECTORIES, DIRTY
OWN - DOWN, TOWN, KNOWN, SHOWN, BROWN, OWNERS, OWNER, UNKNOWN, OWNED, DOWNTOWN
OVE - OVER, LOVE, ABOVE, OVERALL, MOVE, IMPROVE, OVERVIEW, REMOVE, PROVE, GROVE
SCH - SCHOOL, SCHOOLS, SCHEDULE, SCHEME, SCHEDULED, SCHOLARSHIP, SCHEDULES, DEUTSCH, SCHEMES, SCHOLARSHIPS
UGH - THROUGH, THOUGH, ENOUGH, ALTHOUGH, TOUGH, ROUGH, LAUGH, BOROUGH, HUGH, THOROUGH
IMP - IMPORTANT, IMPROVE, IMPACT, IMPLEMENTATION, IMPROVEMENT, IMPORT, IMPROVED, IMPORTANCE, IMPLEMENT, IMPLEMENTED
MOD - MODEL, MODELS, MODE, MODERN, MODIFIED, MODULE, MODULES, MODIFY, MODERATOR, MODEM
MAT - FORMAT, MATERIAL, MATERIALS, MATURE, MATTER, MATCH, MATCHING, MATTERS, MATH, MATRIX
OUS - PREVIOUS, VARIOUS, SERIOUS, RELIGIOUS, ANONYMOUS, MISCELLANEOUS, FAMOUS, CONTINUOUS, NUMEROUS, DANGEROUS
GRE - GREAT, GREEN, GREATER, GREATEST, GREEK, GREECE, GREY, GREG, GREATLY, GREW
MIN - MINUTES, MIND, MINI, MINIMUM, MINISTER, MINUTE, ADMIN, MINNESOTA, MINISTRY, MINOR
AUT - AUTHOR, AUTO, AUTHORITY, AUTHORS, AUTOMOTIVE, AUTOMATICALLY, AUTOMATIC, AUTHORITIES, AUTHORIZED, AUTHENTICATION
SEN - SEND, SENT, SENIOR, SENSE, SENATE, CHOSEN, SENDING, SENSITIVE, SENATOR, SENTENCE
EED - NEED, SPEED, FEED, AGREED, GUARANTEED, INDEED, SEED, EXCEED, REED, PROCEED
OPE - OPEN, EUROPE, HOPE, OPERATING, OPERATIONS, OPERATION, OPENING, OPERATOR, SCOPE, OPENED
ACH - EACH, BEACH, APPROACH, REACH, ACHIEVE, COACH, TEACH, ACHIEVED, ACHIEVEMENT, OUTREACH
CLA - CLASS, CLASSIC, CLASSES, CLAIM, CLASSIFIEDS, CLAIMS, CLASSICAL, CLASSIFIED, CLARK, CLASSROOM
BAC - BACK, BACKGROUND, BACKUP, BACHELOR, BACKED, BACTERIA, BACKGROUNDS, BACTERIAL, BACKING, BACON
NAT - NATIONAL, NATURAL, NATURE, NATION, NATIVE, NATIONS, NATIONWIDE, NATURALLY, NATURALS, NATHAN
SHA - SHALL, SHARE, SHARED, SHARING, SHARES, SHAPE, SHARP, SHAVED, SHADOW, SHAREWARE
NOT - NOTE, NOTICE, NOTES, NOTHING, NOTED, NOTIFY, NOTEBOOK, NOTIFICATION, NOTICES, NOTEBOOKS
CAS - CASE, CASES, CASH, CASINO, CAST, CASTLE, CASINOS, CASUAL, CASSETTE, AMERICAS
MED - MEDIA, MEDICAL, MEDICINE, MEDIUM, INFORMED, NAMED, PUBMED, PERFORMED, SEEMED, FORMED
HIG - HIGH, HIGHER, HIGHEST, HIGHLY, HIGHWAY, HIGHLIGHTS, HIGHLIGHT, HIGHS, HIGHLAND, HIGHLIGHTED
BRO - BROWSE, BROWSER, BROWN, BROUGHT, BROTHER, BROKEN, BROADBAND, BROTHERS, BROAD, BROADCAST
UAL - INDIVIDUAL, ANNUAL, VIRTUAL, VISUAL, MANUAL, ACTUAL, EQUAL, SEXUAL, DUAL, SPIRITUAL
REQ - REQUIRED, REQUEST, REQUIREMENTS, REQUIRE, REQUIRES, REQUESTS, REQUESTED, REQUIREMENT, REQUIRING, REQUESTING
TEC - TECHNOLOGY, TECHNICAL, TECH, TECHNOLOGIES, TECHNIQUES, TECHNIQUE, TECHNOLOGICAL, TECHNO, TECHNICIAN, SYMANTEC
GRA - GRAND, GRAPHICS, GRADE, GRANT, GRADUATE, GRAPHIC, GRATIS, VIAGRA, GRANTS, GRAY
ELS - HOTELS, ELSE, MODELS, LEVELS, CHANNELS, WHEELS, LABELS, ELSEWHERE, ANGELS, FEELS
IED - MODIFIED, SPECIFIED, APPLIED, CERTIFIED, DIED, TRIED, SUPPLIED, IDENTIFIED, MARRIED, CARRIED
WIN - WINDOWS, WINDOW, WINE, WINTER, WIND, WINNING, WINNER, TWIN, WING, WINGS
WER - WERE, POWER, LOWER, ANSWER, FLOWER, TOWER, SHOWER, REVIEWER, FEWER, VIEWER
VES - ARCHIVES, THEMSELVES, GIVES, LIVES, DRIVES, OBJECTIVES, REPRESENTATIVES, LEAVES, INITIATIVES, MOVES
DET - DETAILS, DETAILED, DETAIL, DETERMINE, DETERMINED, DETROIT, DETECTION, DETERMINATION, DETERMINING, DETECTED
ORD - ORDER, PASSWORD, RECORD, WORD, ORDERS, LORD, FORD, KEYWORD, ORDERING, OXFORD
TRY - COUNTRY, INDUSTRY, ENTRY, TRYING, MINISTRY, POETRY, CHEMISTRY, REGISTRY, FORESTRY, GEOMETRY
ADE - MADE, TRADE, GRADE, UPGRADE, ARCADE, ADEQUATE, BLADE, DECADE, PARADE, ADELAIDE
FAC - FACT, FACE, FACILITIES, FACULTY, FACILITY, FACTORS, FACTOR, FACTS, FACTORY, FACES
CIT - CITY, CITIES, CITIZENS, CITIZEN, CITYSEARCH, CITED, CITATION, EXPLICIT, CITATIONS, CITE
LED - CALLED, DETAILED, INSTALLED, FILED, FAILED, FILLED, CONTROLLED, KILLED, DISABLED, ENABLED
SPO - SPORTS, SPONSORED, SPORT, SPONSOR, SPOT, SPORTING, SPONSORS, SPOKE, SPOKEN, SPOTS
TLE - TITLE, LITTLE, SEATTLE, BATTLE, CASTLE, BOTTLE, NEWCASTLE, CATTLE, SHUTTLE, GENTLE
MIL - MILLION, MILES, MILITARY, MILF, MILLER, MILE, MILK, MILLIONS, MILFHUNTER, MILFS
ELY - LIKELY, IMMEDIATELY, APPROXIMATELY, COMPLETELY, EXTREMELY, ABSOLUTELY, RELATIVELY, EFFECTIVELY, UNFORTUNATELY, RESPECTIVELY
HTS - RIGHTS, THOUGHTS, FLIGHTS, LIGHTS, NIGHTS, HIGHLIGHTS, HEIGHTS, COPYRIGHTS, INSIGHTS, WEIGHTS
HAN - THAN, HAND, HANDS, HANDLE, HANDLING, HANDBOOK, JONATHAN, HANDHELD, HANG, HANGING
TLY - CURRENTLY, RECENTLY, DIRECTLY, FREQUENTLY, EXACTLY, SLIGHTLY, MOSTLY, SIGNIFICANTLY, APPARENTLY, PARTLY
SHI - SHIPPING, SHIP, SHIPS, SHIRT, SHIRTS, SHIFT, SHIPPED, SHIT, MITSUBISHI, SHIELD
CAT - CATEGORIES, CATEGORY, CATALOG, CATALOGUE, CATHOLIC, CATCH, CATS, CATERING, CATHERINE, CATTLE
SIG - SIGN, SIGNIFICANT, SIGNED, SIGNAL, SIGNS, SIGNATURE, SIGNIFICANTLY, SIGHT, SIGNALS, SIGMA
ANS - MEANS, LOANS, PLANS, ANSWER, ANSWERS, FANS, AMERICANS, LESBIANS, ORLEANS, TRANS
LAR - LARGE, SIMILAR, POPULAR, PARTICULAR, REGULAR, LARGER, LARGEST, DOLLAR, SOLAR, CELLULAR
PIC - PICTURES, TOPIC, PICTURE, PICS, PICK, PICKS, PICKED, OLYMPIC, PICKUP, PICHUNTER
CED - ADVANCED, PRODUCED, PLACED, FORCED, INTRODUCED, REDUCED, ANNOUNCED, EXPERIENCED, ENHANCED, PRICED
LOW - BELOW, YELLOW, LOWER, FOLLOW, ALLOW, FLOW, LOWEST, BLOW, SLOW, FELLOW
FEE - FEEDBACK, FEEL, FEED, FEET, FEES, COFFEE, FEEDS, FEELING, FEELS, FEEDING
ELE - ELECTRONICS, ELECTRONIC, ELECTRIC, ELEMENTS, ELECTION, ELEMENT, ELECTRICAL, ELEMENTARY, ELECTIONS, ELECTED
ENG - ENGLISH, ENGINEERING, ENGINE, ENGLAND, ENGINES, ENGINEER, ENGINEERS, ENGAGED, ENGAGEMENT, ENGAGE
VEN - EVEN, GIVEN, SEVEN, VENDOR, HEAVEN, DRIVEN, STEVEN, VENTURE, VENDORS, VENUE
ISE - ADVERTISE, ENTERPRISE, OTHERWISE, EXERCISE, RISE, CRUISE, NOISE, RAISE, MERCHANDISE, EXPERTISE
EAT - GREAT, HEAT, SEAT, BEAT, EATING, TREAT, THREAT, MEAT, REPEAT, CHEAT
FOU - FOUND, FOUR, FOUNDATION, FOURTH, FOUNDED, FOUNDER, FOUNDATIONS, FOUNTAIN, FOUGHT, FOUL
CAN - AMERICAN, CANADA, CANCER, CANADIAN, AFRICAN, CANON, CANCEL, CANDIDATE, CANDIDATES, SCAN
BLO - BLOG, BLOOD, BLOCK, BLOGS, BLOW, BLONDE, BLOWJOB, BLOCKS, BLOGGER, BLOWJOBS
TON - WASHINGTON, BUTTON, BOSTON, HOUSTON, TONY, COTTON, TONIGHT, HAMILTON, TONE, HILTON
RET - RETURN, RETURNS, RETAIL, RETURNED, SECRET, RETIREMENT, MARGARET, RETURNING, RETIRED, RETAILER
CAM - CAMERA, CAME, CAMERAS, CAMPUS, CAMPAIGN, CAMP, CAMBRIDGE, SEXCAM, CAMPING, LIVECAM
DEC - DECEMBER, DECISION, DECIDED, DECISIONS, DECIDE, DECK, DECREASE, DECLARATION, DECOR, DECLARED
COR - CORPORATE, CORPORATION, CORE, CORRECT, CORNER, CORRESPONDING, CORRECTIONS, CORRECTLY, CORRECTION, CORP
ETS - TICKETS, SETS, GETS, MARKETS, ASSETS, PETS, SHEETS, MEETS, STREETS, LETS
ALE - SALE, MALE, FEMALE, SCALE, WHOLESALE, ALERT, SHEMALE, ALERTS, ALEXANDER, ALEX
POR - PORN, PORT, PORNO, PORTABLE, PORTAL, PORTFOLIO, PORTION, PORTLAND, PORTS, PORTUGAL
FUN - FUNCTION, FUND, FUNDS, FUNCTIONS, FUNDING, FUNCTIONAL, FUNNY, FUNDAMENTAL, FUNDED, FUNCTIONALITY
HAR - HARD, HARDWARE, HARDCORE, HARRY, HARDCOVER, CHAR, HARRIS, HARBOR, HARVARD, HARM
UNT - ACCOUNT, UNTIL, AMOUNT, DISCOUNT, COUNT, MOUNT, HUNT, UNTITLED, UNTO, CUNT
MER - CUSTOMER, CONSUMER, SUMMER, DISCLAIMER, FORMER, MERCHANT, MERCHANDISE, MERCURY, MERCHANTS, MERCEDES
SUR - SURE, SURVEY, SURFACE, SURGERY, SURVEYS, SURROUNDING, SURPRISE, SURVIVAL, SURF, SURVEILLANCE
SAL - SALE, SALES, UNIVERSAL, PROPOSAL, SALT, SALARY, DISPOSAL, SALON, SALMON, SALEM
LIC - PUBLIC, LICENSE, REPUBLIC, LICENSED, CATHOLIC, LICENSING, LICENCE, LICENSES, LICKING, ITALIC
BEA - BEACH, BEAUTY, BEAUTIFUL, BEAR, BEAT, BEARS, BEASTIALITY, BEAST, BEAM, BEADS
VIS - VISIT, VISUAL, VISITORS, VISION, DAVIS, VISA, VISITING, VISITOR, VISITS, VISIBLE
VAL - VALUE, VALUES, VALLEY, VALID, APPROVAL, FESTIVAL, REMOVAL, VALUABLE, VALENTINE, ARRIVAL
SIN - SINCE, SINGLE, WISCONSIN, SINGLES, SINGAPORE, SINGER, SING, BASIN, SINGING, ASIN
DEA - DEALS, DEATH, IDEA, DEAL, DEAD, DEALER, DEALERS, DEAN, DEAR, DEALING
LON - LONG, LONDON, LONGER, NYLON, SALON, LONELY, LONGEST, COLON, LONE, LONGITUDE
OCK - STOCK, ROCK, BLOCK, COCK, CLOCK, LOCK, SHOCK, LIVESTOCK, UNLOCK, DOCK
PAS - PASSWORD, PAST, PASS, PASSED, PASSING, PASSION, PASSENGER, PASSES, PASSAGE, PASSPORT
NOR - NORTH, NORMAL, NORTHERN, MINOR, GOVERNOR, NORTHWEST, NORWAY, NORMALLY, HONOR, NORTHEAST
GER - GERMANY, MANAGER, LARGER, LONGER, GERMAN, MESSENGER, BLOGGER, ROGER, CHARGER, TIGER
INV - INVESTMENT, INVOLVED, INVESTIGATION, INVESTOR, INVENTORY, INVESTMENTS, INVESTORS, INVOLVING, INVESTING, INVOLVEMENT
NER - OWNER, PARTNER, CORNER, DESIGNER, MANNER, DINNER, WINNER, BANNER, INNER, COMMISSIONER
WAT - WATER, WATCH, WATCHES, WATCHING, WATERS, WATCHED, WATSON, WATT, WATTS, WATERSHED
ATT - ATTENTION, ATTORNEY, ATTACK, ATTEMPT, MATT, ATTRACTIONS, ATTACHED, ATTEND, ATTACKS, ATTORNEYS
GUI - GUIDE, GUIDES, GUIDELINES, GUITAR, GUIDANCE, GUINEA, GUILTY, GUIDED, GUILD, GUITARS
DEP - DEPARTMENT, DEPTH, DEPARTMENTS, DEPENDING, DEPENDENT, DEPOSIT, DEPENDS, DEPRESSION, DEPUTY, DEPARTURE
FOL - FOLLOWING, FOLLOW, FOLLOWS, FOLLOWED, FOLDER, FOLK, FOLKS, FOLD, FOLDERS, FOLDING
REF - REFERENCE, REFERENCES, REFERRED, REFER, REFLECT, REFORM, REFUND, REFINE, REFERS, REFINANCE
