ING - USING, RATING, MAKING, LISTING, GOING, BEING, LIVING
ION - SECTION, ACTION, EDUCATION, LOCATION, EDITION, PROTECTION, PRODUCTION
ENT - RECENT, DEPARTMENT, PERCENT, EVENT, TREATMENT, AGREEMENT, PRESENT
TED - RATED, RELATED, CREATED, POSTED, LOCATED, LISTED, STARTED
ERS - ORDERS, OTHERS, USERS, OWNERS, PARTNERS, CAREERS, ANSWERS
TER - ENTER, PETER, LATER, WATER, AFTER, CENTER, MASTER
ONS - ACTIONS, AUCTIONS, SECTIONS, RELATIONS, LOCATIONS, DIRECTIONS, OPTIONS
IES - CITIES, STORIES, PARTIES, SPECIES, COUNTRIES, SERIES, CATEGORIES
ATE - CREATE, PRIVATE, PLATE, SEPARATE, CLIMATE, STATE, ULTIMATE
NCE - FRANCE, FINANCE, DANCE, DISTANCE, SCIENCE, SINCE, INSURANCE
AGE - MANAGE, AVERAGE, IMAGE, STAGE, VINTAGE, STORAGE, DAMAGE
ITY - ABILITY, QUALITY, UTILITY, FACILITY, REALITY, ACTIVITY, LIABILITY
NTS - PARENTS, PATIENTS, PAYMENTS, AGENTS, APARTMENTS, CLIENTS, COMMENTS
ESS - PRESS, DRESS, PRINCESS, STRESS, PROCESS, EXPRESS, UNLESS
HER - OTHER, EITHER, HEATHER, RATHER, GATHER, FATHER, WEATHER
NAL - OPERATIONAL, OPTIONAL, EMOTIONAL, NATIONAL, TERMINAL, REGIONAL, TRADITIONAL
IVE - ACTIVE, RELATIVE, CREATIVE, NEGATIVE, NATIVE, INTERACTIVE, EXECUTIVE
INE - MAINE, MARINE, MEDLINE, DEADLINE, IMAGINE, ENGINE, EXAMINE
EST - GUEST, NEWEST, DIGEST, LARGEST, FOREST, LATEST, QUEST
CES - PRICES, PIECES, SERVICES, SCIENCES, EXPERIENCES, FORCES, PRACTICES
BLE - RELIABLE, TABLE, VARIABLE, PRINTABLE, ENABLE, SUITABLE, CABLE
URE - FEATURE, NATURE, MATURE, PICTURE, FUTURE, CULTURE, MEASURE
GHT - TIGHT, RIGHT, EIGHT, NIGHT, SIGHT, LIGHT, FIGHT
VER - RIVER, RECOVER, COVER, NEVER, DELIVER, DRIVER, OLIVER
TES - SITES, DATES, SUITES, STATES, RATES, DIABETES, ESTIMATES
ARY - ORDINARY, SECRETARY, DIARY, PRIMARY, SECONDARY, TEMPORARY, LIBRARY
LES - SALES, MILES, ARTICLES, CABLES, FILES, TABLES, WALES
IAL - TRIAL, SERIAL, EDITORIAL, MATERIAL, INTERRACIAL, SOCIAL, SPECIAL
SED - PROCESSED, PASSED, RAISED, PLEASED, CAUSED, RELEASED, INCREASED
CAL - OPTICAL, CRITICAL, TYPICAL, POLITICAL, TROPICAL, CLINICAL, TECHNICAL
RED - ORDERED, POWERED, OFFERED, COVERED, PREPARED, FEATURED, ENTERED
AND - IRELAND, ISLAND, POLAND, STAND, PORTLAND, SCOTLAND, ZEALAND
ECT - PERFECT, RESPECT, PROJECT, PROTECT, REFLECT, DIRECT, ASPECT
DER - OLDER, ORDER, HOLDER, FOLDER, BORDER, WONDER, UNDER
ARE - AWARE, SHAREWARE, ADWARE, HARDWARE, SHARE, SPARE, SPYWARE
ORY - STORY, VICTORY, HISTORY, CATEGORY, DIRECTORY, THEORY, FACTORY
ARD - REWARD, HEARD, AWARD, HOWARD, EDWARD, BOARD, TOWARD
AIN - TRAIN, RETAIN, BRAIN, STRAIN, GRAIN, OBTAIN, REMAIN
TAL - ORIENTAL, RENTAL, MENTAL, DENTAL, METAL, PORTAL, POSTAL
LLY - REALLY, FINALLY, EQUALLY, USUALLY, ESPECIALLY, ACTUALLY, EVENTUALLY
RAL - NEUTRAL, CENTRAL, FUNERAL, MINERAL, GENERAL, INTEGRAL, RURAL
ANT - INSTANT, RESISTANT, PREGNANT, GIANT, GRANT, PLANT, INFANT
RES - FEATURES, LECTURES, CENTRES, PICTURES, STORES, MEASURES, CULTURES
SES - CASES, CAUSES, CLASSES, RELEASES, COURSES, PROCESSES, INCREASES
GES - CHANGES, PAGES, RANGES, WAGES, IMAGES, CHARGES, DAMAGES
RTS - PORTS, SPORTS, REPORTS, EXPORTS, SHORTS, RESORTS, PARTS
DED - ENDED, AMENDED, NEEDED, HEADED, ATTENDED, EXPANDED, ADDED
NGS - RINGS, STRINGS, BRINGS, RATINGS, SPRINGS, WINGS, THINGS
ICS - ETHICS, COSMETICS, CRITICS, COMICS, ATHLETICS, CLINICS, TOPICS
NDS - BANDS, LANDS, HANDS, BRANDS, BONDS, STANDS, SOUNDS
TOR - ACTOR, SECTOR, VECTOR, CREATOR, SENATOR, DIRECTOR, DOCTOR
NED - TRAINED, OBTAINED, CONTAINED, JOINED, OPENED, MENTIONED, DEFINED
IST - WRIST, CHRIST, ARTIST, TOURIST, RESIST, TWIST, FLORIST
VED - SERVED, PROVED, ARRIVED, REMOVED, RESOLVED, DERIVED, RESERVED
ALS - TRIALS, SPECIALS, MATERIALS, RENTALS, MEALS, PERSONALS, SIGNALS
STS - FORESTS, CONTESTS, TESTS, COSTS, EXISTS, LISTS, FLORISTS
SON - PERSON, PRISON, EPSON, MASON, REASON, JASON, SEASON
ORS - DOCTORS, SECTORS, ACTORS, EDITORS, MOTORS, MONITORS, DOORS
NES - LINES, WINES, TONES, BONES, ZONES, JONES, GENES
IAN - ASIAN, BRIAN, ITALIAN, INDIAN, DEBIAN, LESBIAN, GUARDIAN
OUS - VARIOUS, SERIOUS, CURIOUS, NERVOUS, PRECIOUS, PREVIOUS, NUMEROUS
IED - UNIFIED, NOTIFIED, CERTIFIED, SPECIFIED, SATISFIED, VERIFIED, MODIFIED
VES - LIVES, LEAVES, RECEIVES, GIVES, DRIVES, LOVES, BELIEVES
LED - FAILED, FILLED, MAILED, FILED, KILLED, CALLED, SEALED
ELY - RELATIVELY, TIMELY, ENTIRELY, LIKELY, MERELY, ULTIMATELY, SOLELY
TLY - RECENTLY, CORRECTLY, DIRECTLY, CURRENTLY, GREATLY, STRICTLY, PERFECTLY
ISE - RAISE, PRAISE, ARISE, PRECISE, PROMISE, PARADISE, CRUISE
TON - WINSTON, HILTON, CLINTON, ARLINGTON, MILTON, KINGSTON, NORTON
GER - ANGER, SINGER, ROGER, LONGER, STRONGER, DANGER, STRANGER
NER - INNER, BANNER, TRAINER, MANNER, RUNNER, WARNER, WINNER
TIC - MAGNETIC, ROMANTIC, ATLANTIC, AUTOMATIC, EROTIC, ATHLETIC, STATIC
KED - PACKED, BACKED, LOCKED, WALKED, TALKED, TRACKED, NAKED
INS - GAINS, TRAINS, PLAINS, CONTAINS, COINS, CHAINS, REMAINS
CKS - ROCKS, COCKS, RACKS, LOCKS, TRACKS, TRICKS, SOCKS
