ILM - FILM
ABY - BABY
ROM - FROM
ELP - HELP
AFF - STAFF
DEO - VIDEO
EAP - CHEAP
DEL - MODEL
TIL - UNTIL
HOO - YAHOO
NUX - LINUX
NIT - UNIT, KNIT
ALK - TALK, WALK
OAN - LOAN, JOAN
ISK - RISK, DISK
TML - HTML, XHTML
RLS - URLS, GIRLS
ULY - JULY, TRULY
HIN - THIN, WITHIN
PEN - OPEN, HAPPEN
ALF - HALF, BEHALF
PUT - INPUT, OUTPUT
FTS - GIFTS, CRAFTS
ASY - EASY, FANTASY
IGH - HIGH, RALEIGH
NST - CONST, AGAINST
AEL - ISRAEL, MICHAEL
OTO - FOTO, GOTO, PHOTO
REA - AREA, KOREA, ANDREA
UDY - JUDY, STUDY, CLOUDY
DIO - AUDIO, RADIO, STUDIO
MEN - WOMEN, YEMEN, CARMEN
LUS - PLUS, STYLUS, SURPLUS
RGY - ORGY, ENERGY, ALLERGY
GET - BUDGET, TARGET, FORGET
TRE - NOTRE, CENTRE, THEATRE
YPE - TYPE, SKYPE, PROTOTYPE
ADA - CANADA, NEVADA, GRENADA
GIC - MAGIC, LOGIC, STRATEGIC
MUM - MAXIMUM, MINIMUM, OPTIMUM
ONT - FONT, DONT, FRONT, VERMONT
MAS - THOMAS, BAHAMAS, CHRISTMAS
FIT - PROFIT, BENEFIT, NONPROFIT
LTH - HEALTH, WEALTH, COMMONWEALTH
XED - FIXED, MIXED, BOXED, INDEXED
ADY - LADY, READY, STEADY, ALREADY
ULL - FULL, NULL, PULL, BULL, HULL
IEF - CHIEF, BRIEF, RELIEF, BELIEF
HAN - THAN, CHAN, NATHAN, JONATHAN
ECH - TECH, CZECH, SPEECH, LOGITECH
ICH - RICH, WHICH, MUNICH, SANDWICH
EEP - KEEP, DEEP, JEEP, SLEEP, SHEEP
USH - BUSH, PUSH, RUSH, BRUSH, FLUSH
TOS - FOTOS, AUTOS, PHOTOS, ASBESTOS
OBS - JOBS, BOOBS, BLOWJOBS, HANDJOBS
DOM - RANDOM, WISDOM, KINGDOM, FREEDOM
OFT - SOFT, ZOLOFT, JELSOFT, MICROSOFT
APS - MAPS, CAPS, GAPS, CRAPS, PERHAPS
GAL - LEGAL, ILLEGAL, SENEGAL, PORTUGAL
LAY - PLAY, CLAY, DELAY, RELAY, DISPLAY
URN - TURN, BURN, RETURN, SATURN, AUBURN
ROL - CAROL, PATROL, CONTROL, CHOLESTEROL
LOR - COLOR, TAYLOR, BACHELOR, CHANCELLOR
UCT - STRUCT, PRODUCT, CONDUCT, CONSTRUCT
PAL - NEPAL, PAYPAL, PRINCIPAL, MUNICIPAL
UNE - JUNE, TUNE, IMMUNE, FORTUNE, TRIBUNE
IDS - KIDS, AIDS, BIDS, VIDS, ACIDS, RAPIDS
GAN - BEGAN, ORGAN, LOGAN, MORGAN, MICHIGAN
NTO - INTO, ONTO, UNTO, TORONTO, SACRAMENTO
IFE - LIFE, WIFE, KNIFE, WILDLIFE, NIGHTLIFE
THS - PATHS, BATHS, MONTHS, DEATHS, STRENGTHS
EVE - STEVE, SLEEVE, BELIEVE, ACHIEVE, RETRIEVE
NLY - ONLY, MAINLY, COMMONLY, SUDDENLY, CERTAINLY
TEE - TRUSTEE, COMMITTEE, GUARANTEE, SUBCOMMITTEE
ASS - PASS, MASS, BASS, CLASS, GLASS, BRASS, GRASS
ANK - BANK, RANK, TANK, THANK, FRANK, BLANK, SPANK
OTH - BOTH, CLOTH, BOOTH, TOOTH, SMOOTH, BLUETOOTH
GIN - LOGIN, BEGIN, ORIGIN, VIRGIN, PLUGIN, MARGIN
OES - DOES, GOES, SHOES, HEROES, TOMATOES, POTATOES
NTY - COUNTY, TWENTY, PLENTY, WARRANTY, UNCERTAINTY
IGN - SIGN, ALIGN, DESIGN, ASSIGN, FOREIGN, CAMPAIGN
EMS - ITEMS, SEEMS, POEMS, MODEMS, SYSTEMS, PROBLEMS
LOG - BLOG, WEBLOG, ANALOG, DIALOG, CATALOG, CHANGELOG
DLY - BADLY, HARDLY, DEADLY, RAPIDLY, PROUDLY, FRIENDLY
RCH - ARCH, MARCH, SEARCH, CHURCH, RESEARCH, CITYSEARCH
AID - SAID, PAID, LAID, RAID, AFRAID, PREPAID, MEDICAID
UCE - BRUCE, SAUCE, REDUCE, PRODUCE, INTRODUCE, REPRODUCE
UNT - HUNT, CUNT, COUNT, MOUNT, AMOUNT, ACCOUNT, DISCOUNT
OOL - TOOL, COOL, POOL, WOOL, FOOL, BOOL, SCHOOL, LIVERPOOL
UIT - SUIT, QUIT, FRUIT, CIRCUIT, GRATUIT, LAWSUIT, PURSUIT
MIT - LIMIT, ADMIT, SUBMIT, PERMIT, COMMIT, SUMMIT, TRANSMIT
ELF - SELF, SHELF, ITSELF, MYSELF, HIMSELF, HERSELF, YOURSELF
ESE - THESE, CHEESE, CHINESE, JAPANESE, PORTUGUESE, VIETNAMESE
UCK - FUCK, SUCK, LUCK, DUCK, BUCK, TRUCK, CHUCK, STUCK, STRUCK
OST - MOST, POST, COST, LOST, HOST, GHOST, BOOST, FROST, ALMOST
WAY - AWAY, ANYWAY, NORWAY, HIGHWAY, GATEWAY, RAILWAY, BROADWAY
NKS - LINKS, BANKS, TANKS, RANKS, THANKS, DRINKS, THINKS, TWINKS
IFY - NOTIFY, MODIFY, VERIFY, SPECIFY, QUALIFY, JUSTIFY, IDENTIFY
OOM - ROOM, ZOOM, BOOM, DOOM, BLOOM, BEDROOM, BATHROOM, CLASSROOM
ILL - WILL, BILL, HILL, FILL, KILL, TILL, MILL, PILL, STILL, SKILL
OAD - ROAD, LOAD, BROAD, UPLOAD, ABROAD, RELOAD, DOWNLOAD, RAILROAD
EER - BEER, PEER, DEER, SHEER, CAREER, PIONEER, ENGINEER, VOLUNTEER
NCH - INCH, LUNCH, RANCH, BUNCH, BENCH, PUNCH, FRENCH, BRANCH, LAUNCH
NEY - MONEY, HONEY, DISNEY, SYDNEY, KIDNEY, JOURNEY, BRITNEY, ATTORNEY
PES - TYPES, TAPES, HOPES, PIPES, SHAPES, RECIPES, STRIPES, LANDSCAPES
ICK - PICK, DICK, NICK, SICK, RICK, CLICK, QUICK, STICK, THICK, PATRICK
ADS - PADS, LEADS, HEADS, ROADS, READS, BEADS, LOADS, THREADS, DOWNLOADS
ONG - LONG, SONG, KONG, HONG, ALONG, AMONG, WRONG, THONG, STRONG, BELONG
YER - BUYER, LAYER, FLYER, DRYER, MEYER, PLAYER, LAWYER, PRAYER, EMPLOYER
ORK - WORK, YORK, FORK, PORK, CORK, NETWORK, ARTWORK, HOMEWORK, FRAMEWORK
AKE - MAKE, TAKE, LAKE, CAKE, WAKE, FAKE, BRAKE, INTAKE, BUKKAKE, MISTAKE
UST - JUST, MUST, DUST, TRUST, AUGUST, ADJUST, ROBUST, EXHAUST, HOLOCAUST
OSE - ROSE, LOSE, JOSE, DOSE, THOSE, CLOSE, WHOSE, LOOSE, CHOOSE, PURPOSE
MAL - ANIMAL, NORMAL, FORMAL, THERMAL, MINIMAL, OPTIMAL, DECIMAL, INFORMAL
ART - PART, CART, MART, START, HEART, SMART, CHART, APART, STUART, STEWART
QUE - UNIQUE, CHEQUE, ANTIQUE, BOUTIQUE, TECHNIQUE, MOZAMBIQUE, ALBUQUERQUE
LLS - CELLS, CALLS, FALLS, HILLS, DOLLS, POLLS, BILLS, TELLS, WALLS, SKILLS
ITS - HITS, TITS, KITS, BITS, FITS, UNITS, LIMITS, VISITS, CREDITS, BENEFITS
OLD - GOLD, HOLD, TOLD, SOLD, COLD, BOLD, FOLD, ARNOLD, HOUSEHOLD, THRESHOLD
NNY - FUNNY, SUNNY, DANNY, PENNY, JENNY, KENNY, BUNNY, TRANNY, JOHNNY, GRANNY
OPE - HOPE, POPE, ZOPE, ROPE, COPE, SCOPE, SLOPE, EUROPE, ENVELOPE, TELESCOPE
RCE - FORCE, SOURCE, PIERCE, DIVORCE, RESOURCE, COMMERCE, WORKFORCE, ECOMMERCE
LTY - GUILTY, REALTY, FACULTY, PENALTY, ROYALTY, NOVELTY, SPECIALTY, DIFFICULTY
IDE - SIDE, WIDE, HIDE, RIDE, GUIDE, SLIDE, INSIDE, PROVIDE, OUTSIDE, WORLDWIDE
LEY - WILEY, VALLEY, ASHLEY, BAILEY, HARLEY, WESLEY, STANLEY, BRADLEY, BERKELEY
OWS - ROWS, LOWS, SHOWS, KNOWS, FLOWS, ALLOWS, THROWS, WINDOWS, FOLLOWS, SHADOWS
EED - NEED, FEED, SEED, REED, SPEED, AGREED, INDEED, EXCEED, PROCEED, GUARANTEED
CKS - PICKS, COCKS, ROCKS, PACKS, TRACKS, CHECKS, STOCKS, BLOCKS, TRUCKS, ATTACKS
ORD - WORD, LORD, FORD, CORD, RECORD, OXFORD, AFFORD, KEYWORD, PASSWORD, STANFORD
OPS - TOPS, OOPS, SHOPS, STOPS, DROPS, CROPS, TROOPS, LAPTOPS, DESKTOPS, WORKSHOPS
END - SEND, TEND, SPEND, TREND, FRIEND, ATTEND, LEGEND, EXTEND, WEEKEND, RECOMMEND
ACH - EACH, BEACH, REACH, COACH, TEACH, ATTACH, BREACH, STOMACH, APPROACH, OUTREACH
KED - ASKED, NAKED, LIKED, WORKED, LOOKED, LINKED, MARKED, PICKED, CHECKED, TRACKED
RSE - HORSE, NURSE, WORSE, VERSE, PURSE, COURSE, REVERSE, DIVERSE, ADVERSE, UNIVERSE
ELS - FEELS, HOTELS, MODELS, LEVELS, WHEELS, LABELS, ANGELS, PIXELS, PANELS, CHANNELS
UGH - HUGH, TOUGH, ROUGH, LAUGH, THOUGH, ENOUGH, THROUGH, BOROUGH, ALTHOUGH, THOROUGH
DER - ORDER, UNDER, OLDER, READER, LEADER, GENDER, BORDER, WONDER, CONSIDER, PROVIDER
UND - FUND, FOUND, SOUND, ROUND, BOUND, POUND, AROUND, GROUND, BACKGROUND, UNDERGROUND
NET - CNET, ZDNET, JANET, VSNET, PLANET, MAGNET, CABINET, INTERNET, ETHERNET, INTRANET
ASE - CASE, BASE, PHASE, LEASE, PLEASE, RELEASE, DISEASE, DATABASE, PURCHASE, INCREASE
ATE - DATE, RATE, LATE, STATE, ESTATE, CREATE, UPDATE, PRIVATE, CORPORATE, APPROPRIATE
ACE - FACE, RACE, PLACE, SPACE, PEACE, GRACE, SURFACE, REPLACE, INTERFACE, MARKETPLACE
RDS - CARDS, WORDS, BIRDS, YARDS, BOARDS, AWARDS, RECORDS, TOWARDS, KEYWORDS, STANDARDS
EDS - BEDS, NEEDS, FEEDS, SEEDS, LEEDS, BREEDS, SPEEDS, HUNDREDS, PROCEEDS, CLASSIFIEDS
DES - CODES, SIDES, MODES, NODES, GUIDES, GRADES, BESIDES, INCLUDES, PROVIDES, MERCEDES
ARK - PARK, MARK, DARK, CLARK, REMARK, DENMARK, LEXMARK, BOOKMARK, TRADEMARK, BENCHMARK
IME - TIME, CRIME, PRIME, ANIME, REGIME, ANYTIME, SUBLIME, LIFETIME, DEALTIME, MARITIME
STS - POSTS, COSTS, LISTS, TESTS, GUESTS, EXISTS, ARTISTS, BREASTS, REQUESTS, INTERESTS
IVE - LIVE, GIVE, FIVE, DRIVE, ACTIVE, ARCHIVE, RECEIVE, POSITIVE, EFFECTIVE, EXECUTIVE
ARE - CARE, RARE, SHARE, AWARE, SQUARE, COMPARE, PREPARE, SOFTWARE, HARDWARE, HEALTHCARE
ITE - SITE, WHITE, WRITE, QUITE, SUITE, WEBSITE, DESPITE, FAVORITE, SATELLITE, FAVOURITE
TER - AFTER, WATER, ENTER, LATER, CENTER, BETTER, CHAPTER, COMPUTER, REGISTER, NEWSLETTER
PLE - APPLE, PEOPLE, SIMPLE, SAMPLE, COUPLE, TEMPLE, PURPLE, EXAMPLE, MULTIPLE, PRINCIPLE
ELD - HELD, FIELD, YIELD, SHIELD, HANDHELD, SHEFFIELD, FAIRFIELD, SPRINGFIELD, BATTLEFIELD
OOD - GOOD, FOOD, WOOD, MOOD, BLOOD, FLOOD, HOLLYWOOD, CHILDHOOD, UNDERSTOOD, NEIGHBORHOOD
ESS - LESS, PRESS, ACCESS, ADDRESS, PROCESS, EXPRESS, SUCCESS, FITNESS, BUSINESS, WIRELESS
ECT - SELECT, DIRECT, EFFECT, OBJECT, SUBJECT, PROJECT, PERFECT, RESPECT, CONNECT, CORRECT
CLE - CYCLE, UNCLE, CIRCLE, MUSCLE, ORACLE, ARTICLE, VEHICLE, BICYCLE, PARTICLE, MOTORCYCLE
SED - USED, BASED, CLOSED, PASSED, CAUSED, REVISED, PROPOSED, RELEASED, LICENSED, INCREASED
ACY - TRACY, LEGACY, PRIVACY, ACCURACY, PHARMACY, LITERACY, ADVOCACY, DEMOCRACY, CONSPIRACY
HER - OTHER, EITHER, HIGHER, RATHER, ANOTHER, FURTHER, WHETHER, WEATHER, TOGETHER, PUBLISHER
IPS - TIPS, LIPS, SHIPS, CLIPS, TRIPS, CHIPS, PHILIPS, PHILLIPS, PARTNERSHIPS, RELATIONSHIPS
LIC - PUBLIC, ITALIC, GARLIC, ACRYLIC, REPUBLIC, CATHOLIC, METALLIC, HYDRAULIC, TECHREPUBLIC
DGE - EDGE, JUDGE, LODGE, RIDGE, DODGE, BRIDGE, KNOWLEDGE, CAMBRIDGE, CARTRIDGE, ACKNOWLEDGE
UDE - NUDE, DUDE, CRUDE, INCLUDE, EXCLUDE, ATTITUDE, LATITUDE, CONCLUDE, MAGNITUDE, LONGITUDE
GED - AGED, LOGGED, TAGGED, CHANGED, MANAGED, CHARGED, ENGAGED, DAMAGED, ARRANGED, ENCOURAGED
INS - WINS, COINS, BEGINS, REMAINS, DOMAINS, COLLINS, CONTAINS, PROTEINS, EXPLAINS, MOUNTAINS
ORM - FORM, WORM, STORM, REFORM, INFORM, PERFORM, UNIFORM, PLATFORM, TRANSFORM, KNOWLEDGESTORM
TON - BUTTON, BOSTON, COTTON, HILTON, NORTON, HOUSTON, CLINTON, HAMILTON, KINGSTON, WASHINGTON
ERE - HERE, WERE, THERE, WHERE, SEVERE, ANYWHERE, ELSEWHERE, SOMEWHERE, ATMOSPHERE, EVERYWHERE
IER - TIER, EASIER, EARLIER, CARRIER, PREMIER, SOLDIER, COURIER, BARRIER, SUPPLIER, IDENTIFIER
NGS - SONGS, RINGS, THINGS, RATINGS, SAVINGS, SPRINGS, LISTINGS, SETTINGS, MEETINGS, BUILDINGS
ING - USING, BEING, RATING, DURING, LISTING, SHIPPING, SHOPPING, TRAINING, FOLLOWING, INCLUDING
LED - FILED, CALLED, FAILED, FILLED, KILLED, ENABLED, DETAILED, DISABLED, INSTALLED, CONTROLLED
VAL - OVAL, NAVAL, REMOVAL, ARRIVAL, APPROVAL, FESTIVAL, SURVIVAL, INTERVAL, MEDIEVAL, CARNIVAL
ORS - DOORS, ERRORS, COLORS, AUTHORS, FACTORS, EDITORS, VISITORS, OUTDOORS, SPONSORS, DIRECTORS
EES - FEES, SEES, TREES, AGREES, DEGREES, TRUSTEES, REFUGEES, EMPLOYEES, COMMITTEES, GUARANTEES
GES - AGES, PAGES, IMAGES, CHANGES, CHARGES, MESSAGES, PACKAGES, COLLEGES, LANGUAGES, CHALLENGES
IAN - ASIAN, BRIAN, INDIAN, LESBIAN, RUSSIAN, ITALIAN, CANADIAN, CHRISTIAN, PHYSICIAN, AUSTRALIAN
SES - USES, CASES, HOUSES, COURSES, CLASSES, RELEASES, PURPOSES, PROCESSES, ADDRESSES, BUSINESSES
UTE - CUTE, ROUTE, ACUTE, MINUTE, DISPUTE, ABSOLUTE, INSTITUTE, ATTRIBUTE, CONTRIBUTE, SUBSTITUTE
NED - OWNED, JOINED, SIGNED, TURNED, DEFINED, DESIGNED, RETURNED, OBTAINED, CONTAINED, DETERMINED
ORY - STORY, MEMORY, THEORY, HISTORY, FACTORY, CATEGORY, ADVISORY, DIRECTORY, INVENTORY, LABORATORY
HTS - RIGHTS, LIGHTS, NIGHTS, FLIGHTS, HEIGHTS, WEIGHTS, THOUGHTS, INSIGHTS, HIGHLIGHTS, COPYRIGHTS
ICS - PICS, TOPICS, LYRICS, COMICS, PHYSICS, GRAPHICS, POLITICS, ECONOMICS, STATISTICS, ELECTRONICS
ISE - RISE, NOISE, RAISE, CRUISE, EXERCISE, ADVERTISE, OTHERWISE, EXPERTISE, ENTERPRISE, MERCHANDISE
ANT - WANT, PLANT, GRANT, INSTANT, RELEVANT, MERCHANT, IMPORTANT, ASSISTANT, RESTAURANT, SIGNIFICANT
TRY - ENTRY, POETRY, COUNTRY, INDUSTRY, MINISTRY, REGISTRY, FORESTRY, GEOMETRY, CHEMISTRY, PSYCHIATRY
TIC - STATIC, EROTIC, PLASTIC, GENETIC, DOMESTIC, ATLANTIC, MAGNETIC, AUTOMATIC, FANTASTIC, DEMOCRATIC
RLY - EARLY, NEARLY, FAIRLY, CLEARLY, PROPERLY, FORMERLY, REGULARLY, QUARTERLY, SIMILARLY, PARTICULARLY
CED - PLACED, FORCED, PRICED, REDUCED, ADVANCED, PRODUCED, ENHANCED, ANNOUNCED, INTRODUCED, EXPERIENCED
CAL - LOCAL, MEDICAL, MUSICAL, PHYSICAL, CRITICAL, CLINICAL, CHEMICAL, TECHNICAL, POLITICAL, HISTORICAL
FUL - USEFUL, HELPFUL, CAREFUL, POWERFUL, PEACEFUL, GRATEFUL, BEAUTIFUL, WONDERFUL, SUCCESSFUL, MEANINGFUL
IES - MOVIES, SERIES, STORIES, STUDIES, POLICIES, COMPANIES, COUNTRIES, CATEGORIES, ACTIVITIES, ACCESSORIES
ALS - DEALS, GOALS, RENTALS, ANIMALS, SPECIALS, MATERIALS, OFFICIALS, PERSONALS, INDIVIDUALS, PROFESSIONALS
NCY - NANCY, FANCY, AGENCY, CURRENCY, EMERGENCY, FREQUENCY, PREGNANCY, EFFICIENCY, CONSULTANCY, CONSISTENCY
TLY - MOSTLY, PARTLY, EXACTLY, RECENTLY, DIRECTLY, SLIGHTLY, CURRENTLY, FREQUENTLY, APPARENTLY, SIGNIFICANTLY
ION - ACTION, VERSION, SECTION, MILLION, LOCATION, QUESTION, EDUCATION, INFORMATION, DESCRIPTION, APPLICATION
HED - CACHED, REACHED, WATCHED, FINISHED, ATTACHED, LAUNCHED, PUBLISHED, DISPATCHED, ESTABLISHED, ACCOMPLISHED
ENT - CURRENT, CONTENT, COMMENT, PAYMENT, DIFFERENT, EQUIPMENT, MANAGEMENT, GOVERNMENT, DEPARTMENT, DEVELOPMENT
