LEF - LEFT
ALS - ALSO
EAC - EACH
WER - WERE
JOB - JOBS
YAH - YAHOO
GOI - GOING
PAG - PAGE, PAGES
GIF - GIFT, GIFTS
PEO - PEOPLE, PEOPLES
GOL - GOLD, GOLF, GOLDEN
VID - VIDS, VIDEO, VIDEOS
TOD - TODD, TODAY, TODDLER
JAN - JANE, JANET, JANUARY
DIG - DIGIT, DIGEST, DIGITAL
BLU - BLUE, BLUES, BLUETOOTH
RIS - RISK, RISE, RISKS, RISING
JUL - JULY, JULIE, JULIA, JULIAN
SOR - SORT, SORRY, SORTS, SORTED
SYS - SYSTEM, SYSTEMS, SYSTEMATIC
NEV - NEVER, NEVADA, NEVERTHELESS
ISS - ISSN, ISSUE, ISSUES, ISSUED
LEV - LEVY, LEVEL, LEVELS, LEVITRA
AFT - AFTER, AFTERNOON, AFTERWARDS
TOP - TOPS, TOPIC, TOPICS, TOPLESS
JUS - JUST, JUSTIN, JUSTICE, JUSTIFY
HOT - HOTEL, HOTELS, HOTTEST, HOTMAIL
GAL - GALE, GALAXY, GALLERY, GALLERIES
LOS - LOSS, LOST, LOSE, LOSSES, LOSING
YEA - YEAR, YEAH, YEARS, YEAST, YEARLY
MOS - MOST, MOSS, MOSES, MOSTLY, MOSCOW
DUR - DURING, DURHAM, DURABLE, DURATION
SAI - SAID, SAIL, SAINT, SAINTS, SAILING
SAF - SAFE, SAFER, SAFETY, SAFARI, SAFELY
WHO - WHOM, WHOLE, WHOSE, WHORE, WHOLESALE
LAR - LARGE, LARRY, LARGER, LARGEST, LARGELY
MEE - MEET, MEETS, MEETUP, MEETING, MEETINGS
NOV - NOVA, NOVEL, NOVELS, NOVELTY, NOVEMBER
AUS - AUSTIN, AUSTRIA, AUSTRALIA, AUSTRALIAN
MAK - MAKE, MAKES, MAKER, MAKING, MAKERS, MAKEUP
BEC - BECOME, BECAME, BECAUSE, BECOMES, BECOMING
YOU - YOUR, YOUNG, YOUTH, YOURS, YOUNGER, YOURSELF
BUS - BUSH, BUSY, BUSTY, BUSES, BUSINESS, BUSINESSES
BES - BEST, BESIDE, BESIDES, BESTIALITY, BESTSELLERS
NAM - NAME, NAMES, NAMED, NAMELY, NAMIBIA, NAMESPACE
LIK - LIKE, LIKED, LIKES, LIKELY, LIKEWISE, LIKELIHOOD
MAD - MADE, MADRID, MADISON, MADONNA, MADNESS, MADAGASCAR
TOO - TOOK, TOOL, TOOLS, TOOTH, TOOLBAR, TOOLBOX, TOOLKIT
AGE - AGES, AGED, AGENT, AGENCY, AGENTS, AGENDA, AGENCIES
SCI - SCIENCE, SCIENCES, SCIENTIST, SCIENTIFIC, SCIENTISTS
DOM - DOME, DOMAIN, DOMAINS, DOMESTIC, DOMINANT, DOMINICAN
FOO - FOOD, FOOT, FOOL, FOODS, FOOTAGE, FOOTBALL, FOOTWEAR
DAT - DATE, DATA, DATES, DATED, DATING, DATABASE, DATABASES
FUR - FURTHER, FURNITURE, FURNISHED, FURTHERMORE, FURNISHINGS
GAM - GAME, GAMES, GAMMA, GAMING, GAMBLING, GAMECUBE, GAMESPOT
WIS - WISH, WISE, WISDOM, WISHES, WISHING, WISHLIST, WISCONSIN
MES - MESH, MESS, MESA, MESSAGE, MESSAGES, MESSENGER, MESSAGING
FEA - FEAR, FEAT, FEARS, FEATURE, FEATURES, FEATURED, FEATURING
KIN - KING, KIND, KINDS, KINGS, KINDA, KINASE, KINGDOM, KINGSTON
MEN - MENU, MENS, MENT, MENUS, MENTAL, MENTOR, MENTION, MENTIONED
FLA - FLAT, FLAG, FLASH, FLAGS, FLAME, FLAVOR, FLASHING, FLASHERS
BUI - BUILD, BUILT, BUILDS, BUILDER, BUILDING, BUILDERS, BUILDINGS
ALB - ALBUM, ALBUMS, ALBERT, ALBANY, ALBERTA, ALBANIA, ALBUQUERQUE
TIM - TIME, TIMES, TIMER, TIMING, TIMELY, TIMBER, TIMOTHY, TIMELINE
THA - THAT, THAN, THAI, THANK, THATS, THANKS, THAILAND, THANKSGIVING
SKI - SKIN, SKIP, SKILL, SKIRT, SKINS, SKILLS, SKIING, SKIRTS, SKILLED
PAY - PAYS, PAYPAL, PAYING, PAYDAY, PAYMENT, PAYABLE, PAYROLL, PAYMENTS
LIG - LIGHT, LIGHTS, LIGHTER, LIGHTING, LIGHTBOX, LIGHTNING, LIGHTWEIGHT
HUM - HUMAN, HUMOR, HUMANS, HUMIDITY, HUMANITY, HUMANITIES, HUMANITARIAN
TEX - TEXT, TEXAS, TEXTS, TEXTURE, TEXTILE, TEXTBOOK, TEXTILES, TEXTBOOKS
VIR - VIRUS, VIRAL, VIRGIN, VIRTUE, VIRTUAL, VIRUSES, VIRGINIA, VIRTUALLY
LOO - LOOK, LOOP, LOOKS, LOOSE, LOOPS, LOOKED, LOOKUP, LOOKING, LOOKSMART
WEL - WELL, WELLS, WELSH, WELCOME, WELFARE, WELDING, WELLNESS, WELLINGTON
TUR - TURN, TURNS, TURBO, TURNED, TURKEY, TURNER, TURTLE, TURNING, TURKISH
TEA - TEAM, TEAR, TEAMS, TEACH, TEARS, TEACHER, TEACHES, TEACHING, TEACHERS
SIN - SING, SINK, SINCE, SINGH, SINGLE, SINGER, SINGLES, SINGING, SINGAPORE
MAC - MACRO, MACHINE, MACHINES, MACHINERY, MACINTOSH, MACEDONIA, MACROMEDIA
FIL - FILE, FILM, FILL, FILES, FILMS, FILED, FILTER, FILLED, FILING, FILTERS
MOV - MOVE, MOVIE, MOVED, MOVES, MOVIES, MOVING, MOVERS, MOVEMENT, MOVEMENTS
ORI - ORIGIN, ORIGINS, ORIGINAL, ORIENTED, ORIENTAL, ORIGINALLY, ORIENTATION
SUC - SUCH, SUCK, SUCKS, SUCCESS, SUCKING, SUCCEED, SUCCESSFUL, SUCCESSFULLY
PHY - PHYS, PHYSICS, PHYSICAL, PHYSICIAN, PHYSICIANS, PHYSIOLOGY, PHYSICALLY
AGR - AGREE, AGREED, AGREES, AGREEMENT, AGREEMENTS, AGRICULTURE, AGRICULTURAL
SHO - SHOW, SHOP, SHOT, SHORT, SHOWS, SHOES, SHOWN, SHOULD, SHOWING, SHOPPING
DEA - DEAL, DEAD, DEAN, DEAR, DEALS, DEATH, DEALER, DEALERS, DEALING, DEADLINE
CAR - CARE, CARD, CART, CARS, CARDS, CARRY, CAREER, CAREERS, CARRIED, CAROLINA
THI - THIS, THIN, THINK, THING, THIRD, THICK, THINGS, THIRTY, THINKS, THINKING
STO - STOP, STORE, STOCK, STORY, STONE, STORM, STORES, STOCKS, STORIES, STORAGE
LIN - LINE, LINK, LINKS, LINUX, LINES, LINDA, LINEAR, LINKED, LINCOLN, LINGERIE
FEE - FEEL, FEED, FEET, FEES, FEEDS, FEELS, FEELING, FEEDING, FEEDBACK, FEELINGS
WIN - WINE, WIND, WING, WINGS, WINDOW, WINTER, WINNER, WINDOWS, WINNING, WINNERS
RAT - RATE, RATS, RATES, RATED, RATIO, RATING, RATHER, RATIOS, RATINGS, RATIONAL
SAL - SALE, SALT, SALES, SALON, SALEM, SALAD, SALARY, SALMON, SALVADOR, SALARIES
TRU - TRUE, TRUST, TRUTH, TRUCK, TRULY, TRUNK, TRUCKS, TRUSTS, TRUSTED, TRUSTEES
FAI - FAIR, FAIL, FAITH, FAILS, FAIRY, FAILED, FAIRLY, FAILURE, FAILING, FAILURES
CAS - CASE, CASH, CAST, CASES, CASINO, CASTLE, CASUAL, CASINOS, CASTING, CASSETTE
PLA - PLAN, PLAY, PLACE, PLANS, PLANT, PLAYER, PLACES, PLAYERS, PLAYING, PLANNING
BOO - BOOK, BOOT, BOOKS, BOOBS, BOOTS, BOOTY, BOOST, BOOKING, BOOKMARK, BOOKSTORE
HER - HERE, HERO, HERBS, HEREIN, HERALD, HEROES, HERBAL, HEREBY, HERSELF, HERITAGE
SOL - SOLD, SOLO, SOLE, SOLID, SOLAR, SOLVE, SOLELY, SOLUTION, SOLDIERS, SOLUTIONS
TRI - TRIP, TRIM, TRIAL, TRIED, TRIPS, TRIALS, TRIPLE, TRICKS, TRIBUNE, TRIPADVISOR
BLA - BLAH, BLACK, BLANK, BLADE, BLAIR, BLAST, BLAME, BLACKS, BLACKJACK, BLACKBERRY
SEA - SEAT, SEAL, SEAN, SEATS, SEARCH, SEASON, SEALED, SEATTLE, SEARCHES, SEARCHING
FIR - FIRE, FIRM, FIRST, FIRMS, FIRED, FIRES, FIREFOX, FIREWALL, FIREWIRE, FIREPLACE
FLO - FLOW, FLOOR, FLOOD, FLOWS, FLOWER, FLORAL, FLORIDA, FLOWERS, FLORIST, FLORISTS
SHA - SHALL, SHARE, SHAPE, SHARP, SHARED, SHARES, SHAVED, SHADOW, SHARING, SHAREWARE
LIT - LITE, LITTLE, LITERARY, LITERACY, LITHUANIA, LITERALLY, LITERATURE, LITIGATION
LOG - LOGO, LOGS, LOGIN, LOGIC, LOGOS, LOGGED, LOGICAL, LOGGING, LOGITECH, LOGISTICS
CUS - CUSTOM, CUSTOMS, CUSTODY, CUSTOMER, CUSTOMERS, CUSTOMIZE, CUSTOMISE, CUSTOMIZED
SHE - SHED, SHEET, SHELL, SHELF, SHEEP, SHEETS, SHEMALE, SHELTER, SHEMALES, SHEFFIELD
SCO - SCORE, SCOTT, SCOPE, SCOUT, SCORES, SCORED, SCOTIA, SCORING, SCOTLAND, SCOTTISH
EAR - EARN, EARS, EARL, EARLY, EARTH, EARNED, EARLIER, EARNINGS, EARRINGS, EARTHQUAKE
MIN - MIND, MINI, MINE, MINOR, MINUTE, MINUTES, MINIMUM, MINISTER, MINISTRY, MINNESOTA
BRI - BRING, BRIEF, BRIAN, BRIDGE, BRIGHT, BRINGS, BRITISH, BRITAIN, BRISTOL, BRINGING
SEN - SEND, SENT, SENSE, SENIOR, SENATE, SENSOR, SENDING, SENATOR, SENTENCE, SENSITIVE
PAR - PART, PARK, PARTY, PARTS, PARIS, PARENTS, PARTNER, PARTIES, PARTNERS, PARTICULAR
CLO - CLOSE, CLOCK, CLOUD, CLOSED, CLOSER, CLOUDY, CLOTHES, CLOSING, CLOSELY, CLOTHING
WAL - WALL, WALK, WALES, WALLS, WALKER, WALTER, WALKED, WALKING, WALLPAPER, WALLPAPERS
FOL - FOLK, FOLD, FOLKS, FOLLOW, FOLDER, FOLLOWS, FOLDERS, FOLDING, FOLLOWED, FOLLOWING
SPO - SPOT, SPORT, SPOKE, SPOTS, SPORTS, SPOKEN, SPONSOR, SPORTING, SPONSORS, SPONSORED
CLI - CLIP, CLICK, CLIPS, CLIENT, CLINIC, CLIENTS, CLIMATE, CLINTON, CLINICAL, CLICKING
BAS - BASE, BASS, BASED, BASIC, BASIS, BASKET, BASKETS, BASEBALL, BASICALLY, BASKETBALL
POR - PORN, PORT, PORNO, PORTS, PORTAL, PORTION, PORTABLE, PORTLAND, PORTUGAL, PORTFOLIO
MIC - MICE, MICRO, MICHEL, MICHAEL, MICHIGAN, MICHELLE, MICROSOFT, MICROWAVE, MICROPHONE
CEN - CENT, CENTS, CENTER, CENTRE, CENSUS, CENTRAL, CENTURY, CENTERS, CENTRES, CENTURIES
SAT - SATIN, SATURN, SATISFY, SATURDAY, SATELLITE, SATISFIED, SATISFACTION, SATISFACTORY
ALT - ALTO, ALTER, ALTERED, ALTHOUGH, ALTERNATE, ALTERNATIVE, ALTERNATIVES, ALTERNATIVELY
WIL - WILL, WILD, WILEY, WILSON, WILLOW, WILLIAM, WILLING, WILLIAMS, WILDLIFE, WILDERNESS
BAR - BARS, BARE, BARRY, BARNES, BARGAIN, BARBARA, BARRIER, BARGAINS, BARRIERS, BARCELONA
THR - THRU, THREE, THROW, THREAD, THREAT, THROAT, THROUGH, THREADS, THRESHOLD, THROUGHOUT
STU - STUDY, STUFF, STUDIO, STUPID, STUDENT, STUDIES, STUDIOS, STUDIED, STUDENTS, STUDYING
MAT - MATH, MATCH, MATURE, MATTER, MATRIX, MATTERS, MATCHES, MATERIAL, MATCHING, MATERIALS
CHA - CHAT, CHANGE, CHARGE, CHANCE, CHANGES, CHAPTER, CHANNEL, CHANGED, CHARLES, CHARACTER
BRE - BREAK, BREAD, BREED, BREAST, BREAKS, BREATH, BREASTS, BREAKING, BREAKFAST, BREAKDOWN
CHE - CHECK, CHEAP, CHEATS, CHECKS, CHEESE, CHECKED, CHEMICAL, CHECKOUT, CHECKING, CHEMISTRY
FOU - FOUR, FOUL, FOUND, FOURTH, FOUGHT, FOUNDED, FOUNDER, FOUNTAIN, FOUNDATION, FOUNDATIONS
FRE - FREE, FRED, FRESH, FRENCH, FREEDOM, FREIGHT, FREEWARE, FREQUENT, FREQUENCY, FREQUENTLY
CAM - CAME, CAMP, CAMERA, CAMPUS, CAMERAS, CAMPING, CAMPAIGN, CAMPBELL, CAMBRIDGE, CAMCORDER
CHO - CHOSE, CHOIR, CHOOSE, CHOICE, CHOSEN, CHORUS, CHOICES, CHOOSING, CHOCOLATE, CHOLESTEROL
SWI - SWIM, SWISS, SWING, SWIFT, SWITCH, SWIMMING, SWITCHES, SWINGERS, SWITCHING, SWITZERLAND
MOR - MORE, MORAL, MORGAN, MORRIS, MORNING, MOROCCO, MORTGAGE, MOREOVER, MORTGAGES, MORTALITY
FRA - FRAME, FRANK, FRAUD, FRANCE, FRAMES, FRANCIS, FRANKLIN, FRANCISCO, FRAMEWORK, FRANCHISE
MOT - MOTOR, MOTEL, MOTHER, MOTION, MOTORS, MOTELS, MOTHERS, MOTOROLA, MOTORCYCLE, MOTIVATION
UNI - UNIT, UNIX, UNION, UNITS, UNITED, UNIQUE, UNIVERSE, UNIVERSAL, UNIVERSITY, UNIVERSITIES
VIE - VIEW, VIEWS, VIEWED, VIEWER, VIENNA, VIEWING, VIETNAM, VIEWERS, VIETNAMESE, VIEWPICTURE
DIV - DIVE, DIVING, DIVINE, DIVIDE, DIVORCE, DIVERSE, DIVIDED, DIVISION, DIVERSITY, DIVISIONS
NOT - NOTE, NOTES, NOTED, NOTICE, NOTIFY, NOTHING, NOTICES, NOTEBOOK, NOTEBOOKS, NOTIFICATION
REN - RENT, RENO, RENEW, RENTAL, RENTALS, RENEWAL, RENDERED, RENEWABLE, RENDERING, RENAISSANCE
BAT - BATH, BATCH, BATHS, BATTLE, BATMAN, BATTERY, BATHROOM, BATTERIES, BATHROOMS, BATTLEFIELD
REM - REMOTE, REMOVE, REMAIN, REMOVED, REMOVAL, REMAINS, REMARKS, REMEMBER, REMAINED, REMAINING
EXA - EXAM, EXACT, EXAMS, EXAMPLE, EXACTLY, EXAMINE, EXAMPLES, EXAMINED, EXAMINING, EXAMINATION
MEA - MEAN, MEAT, MEANS, MEANT, MEASURE, MEANING, MEASURES, MEASURED, MEASUREMENT, MEASUREMENTS
GEN - GENE, GENRE, GENDER, GENERAL, GENERIC, GENETIC, GENERATE, GENERALLY, GENERATED, GENERATION
ANA - ANAL, ANALOG, ANALYST, ANALYZE, ANATOMY, ANAHEIM, ANALYSIS, ANALYSES, ANALYSTS, ANALYTICAL
CER - CERTAIN, CERAMIC, CEREMONY, CERTIFIED, CERTAINLY, CERTIFICATE, CERTIFICATES, CERTIFICATION
ART - ARTS, ARTIST, ARTHUR, ARTICLE, ARTISTS, ARTWORK, ARTICLES, ARTISTIC, ARTHRITIS, ARTIFICIAL
CUR - CURE, CURVE, CURTIS, CURVES, CURRENT, CURIOUS, CURRENCY, CURRENTLY, CURRICULUM, CURRENCIES
CRI - CRIME, CRISIS, CRIMES, CRICKET, CRITICS, CRITICAL, CRIMINAL, CRITERIA, CRITICISM, CRITERION
HIG - HIGH, HIGHS, HIGHER, HIGHLY, HIGHEST, HIGHWAY, HIGHLAND, HIGHLIGHT, HIGHLIGHTS, HIGHLIGHTED
SPE - SPEED, SPEAK, SPENT, SPEECH, SPECIAL, SPECIES, SPEAKER, SPECIFIC, SPECIFIED, SPECIFICATIONS
DIA - DIAL, DIARY, DIAMOND, DIAGRAM, DIABETES, DIAMETER, DIALOGUE, DIAMONDS, DIAGNOSIS, DIAGNOSTIC
CAP - CAPE, CAPS, CAPITAL, CAPTURE, CAPTAIN, CAPABLE, CAPACITY, CAPTURED, CAPABILITY, CAPABILITIES
DEC - DECK, DECOR, DECIDE, DECIDED, DECEMBER, DECISION, DECREASE, DECLARED, DECISIONS, DECLARATION
MAI - MAIL, MAIN, MAINE, MAINLY, MAILING, MAINTAIN, MAINLAND, MAINTAINED, MAINTENANCE, MAINTAINING
COO - COOL, COOK, COOPER, COOKIE, COOKING, COOKIES, COOLING, COOPERATION, COORDINATOR, COOPERATIVE
INC - INCH, INCOME, INCEST, INCLUDE, INCLUDES, INCLUDED, INCREASE, INCLUDING, INCREASED, INCREASING
MIS - MISS, MISC, MISSED, MISSION, MISSING, MISTAKE, MISSOURI, MISSIONS, MISSISSIPPI, MISCELLANEOUS
PRE - PREV, PRESS, PRETTY, PRESENT, PREMIUM, PREVIOUS, PRESSURE, PRESIDENT, PRESENTED, PRESENTATION
MEM - MEMO, MEMBER, MEMORY, MEMBERS, MEMPHIS, MEMORIAL, MEMORIES, MEMBRANE, MEMBERSHIP, MEMORABILIA
PRA - PRAY, PRAYER, PRAGUE, PRAISE, PRAIRIE, PRAYERS, PRACTICE, PRACTICES, PRACTICAL, PRACTITIONERS
EXC - EXCEL, EXCEPT, EXCESS, EXCEED, EXCHANGE, EXCITING, EXCELLENT, EXCLUSIVE, EXCEPTION, EXCELLENCE
STR - STREET, STRONG, STRING, STREAM, STRATEGY, STRAIGHT, STRENGTH, STRUCTURE, STRATEGIC, STRATEGIES
ARR - ARRAY, ARROW, ARRIVE, ARRIVAL, ARRIVED, ARRANGE, ARRANGED, ARRESTED, ARRANGEMENT, ARRANGEMENTS
VOL - VOLT, VOLVO, VOLUME, VOLTAGE, VOLUMES, VOLUNTEER, VOLUNTARY, VOLUNTEERS, VOLLEYBALL, VOLKSWAGEN
TER - TERM, TERMS, TERRY, TERROR, TERMINAL, TERRITORY, TERRORISM, TERRORIST, TERRITORIES, TERMINATION
VER - VERY, VERIFY, VERSUS, VERSION, VERMONT, VERSIONS, VERTICAL, VERIFIED, VERZEICHNIS, VERIFICATION
EXE - EXEC, EXEMPT, EXECUTE, EXERCISE, EXECUTED, EXECUTIVE, EXECUTION, EXERCISES, EXEMPTION, EXECUTIVES
DOC - DOCS, DOCK, DOCTOR, DOCTORS, DOCUMENT, DOCTRINE, DOCUMENTS, DOCUMENTED, DOCUMENTARY, DOCUMENTATION
APP - APPLY, APPLE, APPEAR, APPLIED, APPAREL, APPROACH, APPROVED, APPLICATION, APPROPRIATE, APPLICATIONS
DEF - DEFINE, DEFAULT, DEFINED, DEFENSE, DEFENCE, DEFINES, DEFENDANT, DEFINITION, DEFINITELY, DEFINITIONS
REP - REPLY, REPORT, REPAIR, REPORTS, REPLIES, REPUBLIC, REPORTED, REPORTING, REPLACEMENT, REPRESENTATIVE
DIR - DIRTY, DIRECT, DIRECTOR, DIRECTLY, DIRECTED, DIRECTORY, DIRECTION, DIRECTORS, DIRECTIONS, DIRECTORIES
ARC - ARCH, ARCADE, ARCTIC, ARCHIVE, ARCHIVES, ARCHIVED, ARCHITECT, ARCHITECTS, ARCHITECTURE, ARCHITECTURAL
IDE - IDEA, IDEAS, IDEAL, IDENTIFY, IDENTITY, IDENTICAL, IDENTIFIED, IDENTIFIER, IDENTIFYING, IDENTIFICATION
COR - CORE, CORP, CORNER, CORRECT, CORPORATE, CORRECTLY, CORRECTION, CORPORATION, CORRECTIONS, CORRESPONDING
QUA - QUALITY, QUARTER, QUANTUM, QUALIFY, QUANTITY, QUARTERS, QUALIFIED, QUARTERLY, QUANTITIES, QUALIFICATIONS
CON - CONTACT, CONTROL, CONTENT, CONTENTS, CONTINUE, CONSUMER, CONDITION, CONDITIONS, CONFERENCE, CONSTRUCTION
DEV - DEVEL, DEVICE, DEVELOP, DEVICES, DEVELOPED, DEVELOPER, DEVELOPING, DEVELOPERS, DEVELOPMENT, DEVELOPMENTS
ANN - ANNE, ANNA, ANNUAL, ANNOUNCE, ANNOUNCED, ANNOUNCES, ANNOTATION, ANNIVERSARY, ANNOUNCEMENT, ANNOUNCEMENTS
ADV - ADVICE, ADVANCE, ADVISOR, ADVANCED, ADVISORY, ADVERTISE, ADVENTURE, ADVANTAGE, ADVERTISING, ADVERTISEMENT
PUB - PUBLIC, PUBMED, PUBLISH, PUBLICLY, PUBLISHED, PUBLISHER, PUBLISHING, PUBLISHERS, PUBLICATION, PUBLICATIONS
REG - REGION, REGULAR, REGIONS, REGISTER, REGIONAL, REGARDING, REGISTERED, REGULATION, REGULATIONS, REGISTRATION
REL - RELATED, RELEASE, RELEASES, RELEASED, RELEVANT, RELIGION, RELATIONS, RELIGIOUS, RELATIONSHIP, RELATIONSHIPS
ASS - ASSETS, ASSIST, ASSEMBLY, ASSISTANT, ASSOCIATE, ASSOCIATED, ASSESSMENT, ASSISTANCE, ASSOCIATES, ASSOCIATION
INF - INFO, INFANT, INFORM, INFORMED, INFLUENCE, INFECTION, INFLATION, INFORMATION, INFORMATIONAL, INFRASTRUCTURE
RES - RESULT, RESULTS, RESEARCH, RESERVED, RESOURCE, RESPONSE, RESOURCES, RESPONSIBLE, RESTAURANTS, RESPONSIBILITY
IMP - IMPACT, IMPORT, IMPROVE, IMPROVED, IMPORTANT, IMPLEMENT, IMPORTANCE, IMPROVEMENT, IMPLEMENTED, IMPLEMENTATION
INS - INSIDE, INSTEAD, INSTALL, INSURANCE, INSTITUTE, INSTALLED, INSTRUMENTS, INSTRUCTIONS, INSTALLATION, INSTITUTIONS
INV - INVOLVED, INVESTOR, INVENTORY, INVESTORS, INVOLVING, INVESTING, INVESTMENT, INVESTMENTS, INVOLVEMENT, INVESTIGATION
UND - UNDER, UNDERWEAR, UNDEFINED, UNDERSTAND, UNDERSTOOD, UNDERLYING, UNDERTAKEN, UNDERGROUND, UNDERSTANDING, UNDERGRADUATE
