ELL - WELL, SELL, CELL, TELL, DELL, BELL, HELL, FELL, SHELL, RUSSELL
ICK - PICK, DICK, NICK, SICK, RICK, CLICK, QUICK, STICK, THICK, PATRICK
OSE - ROSE, LOSE, JOSE, DOSE, THOSE, CLOSE, WHOSE, LOOSE, CHOOSE, PURPOSE
AKE - MAKE, TAKE, LAKE, CAKE, WAKE, FAKE, BRAKE, INTAKE, BUKKAKE, MISTAKE
ILL - WILL, BILL, HILL, FILL, KILL, TILL, STILL, SKILL, ILLEGAL, ILLINOIS
ONG - LONG, SONG, KONG, HONG, ALONG, AMONG, WRONG, STRONG, BELONG, ONGOING
EAR - YEAR, NEAR, HEAR, GEAR, EARLY, CLEAR, EARTH, APPEAR, EARLIER, NUCLEAR
AIL - MAIL, FAIL, RAIL, TAIL, NAIL, EMAIL, TRAIL, RETAIL, DETAIL, THUMBNAIL
ALL - CALL, FALL, HALL, WALL, SMALL, SHALL, ALLOW, ALLOWS, OVERALL, FOOTBALL
FIL - FILE, FILM, FILL, FILES, FILMS, FILED, FILTER, FILLED, FILING, FILTERS
AVE - HAVE, SAVE, GAVE, DAVE, WAVE, LEAVE, SLAVE, AVENUE, AVERAGE, MICROWAVE
SHO - SHOW, SHOP, SHOT, SHORT, SHOWS, SHOES, SHOWN, SHOULD, SHOWING, SHOPPING
AST - LAST, EAST, PAST, FAST, CAST, LEAST, COAST, BREAST, FORECAST, BREAKFAST
VER - OVER, VERY, EVER, NEVER, COVER, RIVER, SERVER, SILVER, VERSION, HOWEVER
HEL - HELP, HELD, HELL, HELLO, HELPS, HELEN, HELPED, RACHEL, HELPFUL, HELPING
ARS - CARS, BARS, WARS, MARS, YEARS, STARS, BEARS, DOLLARS, APPEARS, SEMINARS
WIN - WINE, WIND, TWIN, WING, WINGS, WINDOW, WINTER, WINNER, WINDOWS, WINNING
USE - USED, USER, USES, HOUSE, USERS, CAUSE, ABUSE, USEFUL, BECAUSE, USERNAME
EAD - READ, HEAD, LEAD, DEAD, AHEAD, BREAD, THREAD, SPREAD, INSTEAD, OVERHEAD
EST - BEST, WEST, TEST, REST, GUEST, ESTATE, LATEST, INCEST, REQUEST, INTEREST
REA - READ, REAL, AREA, READY, REACH, REALLY, REASON, READER, READING, REASONS
THI - THIS, THIN, THINK, THING, THIRD, THICK, THINGS, THIRTY, THINKS, THINKING
OWN - DOWN, TOWN, KNOWN, SHOWN, BROWN, OWNER, OWNED, OWNERS, UNKNOWN, DOWNTOWN
CAR - CARE, CARD, CART, CARS, CARDS, CARRY, CAREER, CAREERS, CARRIED, CAROLINA
AYS - DAYS, SAYS, WAYS, PAYS, PLAYS, ALWAYS, ESSAYS, DELAYS, HOLIDAYS, DISPLAYS
ART - PART, CART, ARTS, START, HEART, SMART, ARTIST, ARTICLE, ARTISTS, ARTICLES
OVE - OVER, LOVE, MOVE, ABOVE, PROVE, GROVE, REMOVE, OVERALL, IMPROVE, OVERVIEW
GRE - GREY, GREG, GREW, GREAT, GREEN, GREEK, GREECE, GREATER, GREATLY, GREATEST
STO - STOP, STORE, STOCK, STORY, STONE, STORM, STORES, STOCKS, STORIES, STORAGE
GRO - GROW, GROUP, GROSS, GROVE, GROWN, GROUPS, GROWTH, GROUND, GROWING, GROUNDS
WER - WERE, POWER, LOWER, TOWER, FEWER, ANSWER, FLOWER, SHOWER, VIEWER, REVIEWER
HEA - HEAD, HEAR, HEAT, HEART, HEARD, HEAVY, HEALTH, HEARING, HEALTHY, HEADLINES
EED - NEED, FEED, SEED, REED, SPEED, AGREED, INDEED, EXCEED, PROCEED, GUARANTEED
LIN - LINE, LINK, LINKS, LINUX, LINES, LINEAR, LINKED, BERLIN, LINCOLN, LINGERIE
ITE - SITE, ITEM, ITEMS, WHITE, WRITE, QUITE, SUITE, WEBSITE, FAVORITE, SATELLITE
ONE - DONE, NONE, ZONE, PHONE, STONE, ALONE, ANYONE, SOMEONE, EVERYONE, TELEPHONE
AIN - MAIN, PAIN, AGAIN, SPAIN, CHAIN, BRAIN, DOMAIN, CERTAIN, MOUNTAIN, MAINTAIN
FOR - FORM, FORUM, FORCE, FORMS, FORUMS, FORMAT, FORMER, FOREST, FOREIGN, FORWARD
OUR - YOUR, FOUR, TOUR, HOUR, POUR, COLOUR, LABOUR, HARBOUR, BEHAVIOUR, OURSELVES
WOR - WORK, WORD, WORLD, WORKS, WORDS, WORTH, WORKED, WORKING, WORKERS, WORLDWIDE
OOK - BOOK, LOOK, TOOK, COOK, HOOK, EBOOK, OUTLOOK, NOTEBOOK, HANDBOOK, GUESTBOOK
PLA - PLAN, PLAY, PLACE, PLANS, PLANT, PLAYER, PLACES, PLAYERS, PLAYING, PLANNING
ARD - CARD, HARD, BOARD, AWARD, HEARD, TOWARD, EDWARD, FORWARD, RICHARD, STANDARD
BOO - BOOK, BOOT, BOOKS, BOOBS, BOOTS, BOOTY, BOOST, BOOKING, BOOKMARK, BOOKSTORE
OME - HOME, SOME, COME, ROME, BECOME, INCOME, WELCOME, AWESOME, OUTCOME, SYNDROME
ORD - WORD, LORD, FORD, ORDER, RECORD, ORDERS, OXFORD, KEYWORD, PASSWORD, ORDERING
ACK - BACK, PACK, JACK, LACK, BLACK, TRACK, ATTACK, FEEDBACK, PAPERBACK, TRACKBACK
ILE - FILE, MILE, TILE, WHILE, CHILE, SMILE, MOBILE, PROFILE, JUVENILE, AUTOMOBILE
RAT - RATE, RATS, RATES, RATED, RATIO, RATING, RATHER, RATINGS, RATIONAL, DEMOCRAT
CHI - CHIP, CHINA, CHILD, CHIEF, CHILE, CHIPS, CHICAGO, CHINESE, CHICKEN, CHILDREN
END - SEND, ENDS, ENDED, SPEND, FRIEND, ENDING, ATTEND, LEGEND, WEEKEND, RECOMMEND
CAS - CASE, CASH, CAST, CASES, CASINO, CASTLE, CASUAL, CASINOS, CASSETTE, AMERICAS
THE - THEY, THEM, THEN, THEIR, THERE, THESE, THEORY, THERAPY, THEREFORE, THEMSELVES
AME - NAME, SAME, GAME, CAME, FRAME, BECAME, AMERICA, AMERICAN, USERNAME, AMENDMENT
AND - HAND, LAND, BAND, BRAND, GRAND, ISLAND, ENGLAND, COMMAND, IRELAND, UNDERSTAND
SEA - SEAT, SEAL, SEAN, SEATS, SEARCH, SEASON, SEALED, SEATTLE, SEARCHES, SEARCHING
ICE - NICE, PRICE, VOICE, OFFICE, NOTICE, ADVICE, CHOICE, POLICE, SERVICE, PRACTICE
ISH - WISH, FISH, DISH, IRISH, FINISH, JEWISH, ENGLISH, BRITISH, SPANISH, ESTABLISH
LES - LESS, SALES, FILES, MILES, RULES, TITLES, LESBIAN, ANGELES, CHARLES, ARTICLES
ORT - SORT, PORT, SHORT, SPORT, REPORT, RESORT, EFFORT, SUPPORT, AIRPORT, TRANSPORT
IDE - SIDE, WIDE, IDEA, GUIDE, IDEAS, INSIDE, PROVIDE, OUTSIDE, IDENTIFY, WORLDWIDE
GHT - RIGHT, NIGHT, LIGHT, MIGHT, EIGHT, WEIGHT, FLIGHT, THOUGHT, BROUGHT, COPYRIGHT
FIR - FIRE, FIRM, FIRST, FIRMS, FIRED, FIRES, FIREFOX, FIREWALL, FIREWIRE, FIREPLACE
GRA - GRAY, GRAND, GRADE, GRANT, GRATIS, VIAGRA, GRANTS, GRAPHIC, GRAPHICS, GRADUATE
ADE - MADE, TRADE, GRADE, BLADE, ARCADE, DECADE, PARADE, UPGRADE, ADEQUATE, ADELAIDE
SHA - SHALL, SHARE, SHAPE, SHARP, SHARED, SHARES, SHAVED, SHADOW, SHARING, SHAREWARE
ARE - AREA, CARE, RARE, AREAS, SHARE, SQUARE, COMPARE, SOFTWARE, HARDWARE, HEALTHCARE
SON - SONY, SONG, SONGS, PERSON, SEASON, REASON, WILSON, JOHNSON, JACKSON, COMPARISON
NDS - ENDS, FUNDS, HANDS, KINDS, BRANDS, SOUNDS, FRIENDS, ISLANDS, SECONDS, THOUSANDS
DER - ORDER, UNDER, OLDER, READER, LEADER, GENDER, BORDER, WONDER, CONSIDER, PROVIDER
EVE - EVEN, EVER, EVERY, EVENT, STEVE, EVENTS, BELIEVE, EVENING, EVERYONE, EVERYTHING
MES - GAMES, TIMES, JAMES, NAMES, HOMES, COMES, MESSAGE, BECOMES, MESSAGES, SOMETIMES
PRI - PRICE, PRINT, PRIOR, PRIME, PRICES, PRIVACY, PRIVATE, PRINTER, PRIMARY, PRICING
STA - STAR, STAY, STATE, START, STAFF, STATES, STATUS, STANDARD, STATEMENT, STANDARDS
UGH - HUGH, TOUGH, ROUGH, LAUGH, THOUGH, ENOUGH, THROUGH, BOROUGH, ALTHOUGH, THOROUGH
EEN - BEEN, TEEN, SEEN, GREEN, QUEEN, SCREEN, BETWEEN, FIFTEEN, HALLOWEEN, WIDESCREEN
ASE - CASE, BASE, PHASE, LEASE, PLEASE, RELEASE, DISEASE, DATABASE, PURCHASE, INCREASE
HEN - WHEN, THEN, HENRY, HENCE, COHEN, HENTAI, KITCHEN, STEPHEN, HENDERSON, STRENGTHEN
MOD - MODE, MODEL, MODEM, MODELS, MODERN, MODULE, MODIFY, MODULES, MODIFIED, MODERATOR
SER - USER, SERVE, LASER, SERIES, SERVER, SERVICE, BROWSER, SERVERS, SERIOUS, SERVICES
PAR - PART, PARK, PARTY, PARTS, PARIS, PARENTS, PARTNER, PARTIES, PARTNERS, PARTICULAR
TER - TERM, AFTER, TERMS, WATER, ENTER, CENTER, BETTER, COMPUTER, REGISTER, NEWSLETTER
RTS - ARTS, PARTS, SPORTS, SHIRTS, CHARTS, STARTS, REPORTS, EFFORTS, EXPERTS, SUPPORTS
SEN - SEND, SENT, SENSE, SENIOR, SENATE, CHOSEN, SENDING, SENATOR, SENTENCE, SENSITIVE
TES - TEST, SITES, RATES, NOTES, STATES, QUOTES, MINUTES, TESTING, UPDATES, ASSOCIATES
ATE - DATE, RATE, LATE, STATE, ESTATE, CREATE, UPDATE, PRIVATE, CORPORATE, APPROPRIATE
ACE - FACE, RACE, PLACE, SPACE, PEACE, GRACE, SURFACE, REPLACE, INTERFACE, MARKETPLACE
ELS - ELSE, FEELS, HOTELS, MODELS, LEVELS, WHEELS, LABELS, ANGELS, CHANNELS, ELSEWHERE
IME - TIME, CRIME, PRIME, ANIME, REGIME, ANYTIME, SUBLIME, LIFETIME, DEALTIME, MARITIME
CLI - CLIP, CLICK, CLIPS, CLIENT, CLINIC, CLIENTS, CLIMATE, CLINTON, CLINICAL, CLICKING
IST - LIST, HIST, EXIST, ARTIST, ASSIST, CHRIST, TOURIST, FLORIST, WISHLIST, SPECIALIST
RDS - CARDS, WORDS, BIRDS, YARDS, BOARDS, AWARDS, RECORDS, TOWARDS, KEYWORDS, STANDARDS
FAC - FACT, FACE, FACTS, FACES, FACTOR, FACULTY, FACTORS, FACTORY, FACILITY, FACILITIES
COU - COULD, COURT, COUNT, COUNTY, COURSE, COUPLE, COUNTRY, COUNCIL, COURSES, COUNTRIES
MAR - MARK, MARY, MARCH, MARKET, MARTIN, MARINE, MARKETS, MARYLAND, MARRIAGE, MARKETING
LEA - LEAD, LEARN, LEAST, LEAVE, LEAGUE, LEADER, LEADING, LEATHER, LEARNING, LEADERSHIP
HER - HERE, OTHER, EITHER, HIGHER, RATHER, ANOTHER, FURTHER, WHETHER, WEATHER, TOGETHER
IVE - LIVE, GIVE, FIVE, DRIVE, ACTIVE, ARCHIVE, RECEIVE, POSITIVE, EFFECTIVE, EXECUTIVE
ORE - MORE, CORE, STORE, SCORE, BEFORE, OREGON, EXPLORE, HARDCORE, THEREFORE, SINGAPORE
MIN - MIND, MINI, ADMIN, MINOR, MINUTE, MINUTES, MINIMUM, MINISTER, MINISTRY, MINNESOTA
STS - POSTS, COSTS, LISTS, TESTS, GUESTS, EXISTS, ARTISTS, BREASTS, REQUESTS, INTERESTS
BAS - BASE, BASS, BASED, BASIC, BASIS, BASKET, BASKETS, BASEBALL, BASICALLY, BASKETBALL
SEL - SELL, SELF, SELECT, SELLER, DIESEL, SELLERS, SELLING, COUNSEL, SELECTED, SELECTION
CEN - CENT, CENTS, CENTER, CENTRE, CENSUS, CENTRAL, CENTURY, CENTERS, CENTRES, CENTURIES
MON - MONEY, MONTH, SIMON, MONTHS, COMMON, MONDAY, MONTHLY, MONITOR, MONTANA, MONITORING
CRE - CREW, CREEK, CREAM, CREDIT, CREATE, CREATED, CREDITS, CREATIVE, CREATING, CREATION
WIL - WILL, WILD, WILEY, WILSON, WILLOW, WILLIAM, WILLING, WILLIAMS, WILDLIFE, WILDERNESS
LOC - LOCK, LOCAL, LOCATE, LOCKED, LOCALE, LOCATED, LOCATOR, LOCALLY, LOCATION, LOCATIONS
UAL - DUAL, EQUAL, ANNUAL, VISUAL, MANUAL, ACTUAL, SEXUAL, VIRTUAL, SPIRITUAL, INDIVIDUAL
MUS - MUST, MUSIC, MUSEUM, MUSCLE, MUSLIM, MUSICAL, MUSEUMS, MUSLIMS, MUSICIAN, MUSICIANS
SOU - SOUL, SOUTH, SOUND, SOURCE, SOUNDS, SOUGHT, SOURCES, SOUTHERN, SOUTHWEST, SOUTHEAST
THR - THRU, THREE, THROW, THREAD, THREAT, THROAT, THROUGH, THREADS, THRESHOLD, THROUGHOUT
POS - POST, POSTS, POSTED, POSTER, POSTAL, POSTERS, POSTING, POSSIBLE, POSITION, POSITIVE
MAT - MATH, MATCH, FORMAT, MATURE, MATTER, MATRIX, MATTERS, MATERIAL, MATCHING, MATERIALS
MOR - MORE, HUMOR, MORAL, MORGAN, MORRIS, MORNING, MOROCCO, MORTGAGE, MOREOVER, MORTGAGES
CHE - CHECK, CHEAP, CACHE, CHEATS, CHECKS, CHEESE, CHEMICAL, CHECKOUT, CHECKING, CHEMISTRY
ACH - EACH, BEACH, REACH, COACH, TEACH, ACHIEVE, APPROACH, ACHIEVED, OUTREACH, ACHIEVEMENT
ANY - MANY, ANYONE, ANYWAY, ALBANY, COMPANY, GERMANY, ANYTIME, TIFFANY, ANYTHING, ANYWHERE
DAY - DAYS, TODAY, FRIDAY, MONDAY, SUNDAY, HOLIDAY, TUESDAY, SATURDAY, THURSDAY, WEDNESDAY
STU - STUDY, STUFF, STUDIO, STUPID, STUDENT, STUDIES, STUDIOS, STUDIED, STUDENTS, STUDYING
MED - MEDIA, NAMED, MEDIUM, PUBMED, SEEMED, FORMED, MEDICAL, MEDICINE, INFORMED, PERFORMED
LIS - LIST, LISA, LISTS, LISTED, LISTEN, CIALIS, LISTING, LISTINGS, LISTENING, MINNEAPOLIS
OOD - GOOD, FOOD, WOOD, MOOD, BLOOD, FLOOD, HOLLYWOOD, CHILDHOOD, UNDERSTOOD, NEIGHBORHOOD
CHA - CHAT, CHANGE, CHARGE, CHANCE, CHANGES, CHAPTER, CHANNEL, CHANGED, CHARLES, CHARACTER
ESS - LESS, PRESS, ACCESS, ADDRESS, PROCESS, EXPRESS, SUCCESS, FITNESS, BUSINESS, WIRELESS
FIN - FIND, FINE, FINAL, FINISH, FINANCE, FINALLY, FINDING, FINISHED, FINANCIAL, FINANCING
ECT - SELECT, DIRECT, EFFECT, OBJECT, SUBJECT, PROJECT, PERFECT, RESPECT, CONNECT, CORRECT
POL - POLL, POLLS, POLICY, POLICE, POLAND, POLISH, POLICIES, POLITICS, POLITICAL, POLLUTION
EXT - NEXT, TEXT, EXTRA, EXTENT, CONTEXT, EXTREME, EXTERNAL, EXTENDED, EXTENSION, EXTREMELY
BLE - ABLE, TABLE, CABLE, BIBLE, DOUBLE, ENABLE, POSSIBLE, VARIABLE, AVAILABLE, RESPONSIBLE
SED - USED, BASED, CLOSED, PASSED, CAUSED, REVISED, PROPOSED, RELEASED, LICENSED, INCREASED
AGE - PAGE, IMAGE, AGENCY, MESSAGE, AVERAGE, STORAGE, PACKAGE, LANGUAGE, MORTGAGE, HOMEPAGE
THO - THOU, THOSE, THOUGH, THOMAS, THONGS, THOUGHT, THOUGHTS, THOUSAND, THOMPSON, THOUSANDS
INE - LINE, FINE, WINE, ONLINE, ENGINE, MACHINE, MAGAZINE, MEDICINE, DETERMINE, PHENTERMINE
VIE - VIEW, MOVIE, VIEWS, VIEWED, VIEWER, VIENNA, VIEWING, VIETNAM, VIETNAMESE, VIEWPICTURE
URE - SURE, FUTURE, FIGURE, NATURE, MATURE, PICTURE, CULTURE, FEATURE, FURNITURE, STRUCTURE
IND - FIND, MIND, KIND, INDEX, INDIA, INDIAN, INDUSTRY, INDIVIDUAL, INDUSTRIAL, INDEPENDENT
PLE - APPLE, PEOPLE, PLEASE, SIMPLE, SAMPLE, COUPLE, EXAMPLE, MULTIPLE, PLEASURE, PRINCIPLE
HOU - HOUR, THOU, HOUSE, HOURS, HOUSES, HOUSING, HOUSTON, HOUSEHOLD, HOUSEWARES, HOUSEHOLDS
ERY - VERY, EVERY, QUERY, GALLERY, BATTERY, SURGERY, MYSTERY, DELIVERY, RECOVERY, DISCOVERY
OPE - OPEN, HOPE, SCOPE, EUROPE, OPENED, OPENING, OPERATOR, OPERATING, OPERATION, OPERATIONS
TAL - TALK, TOTAL, METAL, RENTAL, MENTAL, DIGITAL, CAPITAL, TALKING, HOSPITAL, ENVIRONMENTAL
FRE - FREE, FRED, FRESH, FRENCH, FREEDOM, FREIGHT, FREEWARE, FREQUENT, FREQUENCY, FREQUENTLY
SIT - SITE, SITES, VISIT, SITEMAP, TRANSIT, DEPOSIT, SITTING, SITUATED, SITUATION, SITUATIONS
BRO - BROWN, BROAD, BROWSE, BROKEN, BROWSER, BROUGHT, BROTHER, BROTHERS, BROADBAND, BROADCAST
UNI - UNIT, UNIX, UNION, UNITS, UNITED, UNIQUE, UNIVERSE, UNIVERSAL, UNIVERSITY, UNIVERSITIES
UND - FUND, UNDER, FOUND, SOUND, ROUND, AROUND, GROUND, UNDERSTAND, BACKGROUND, UNDERSTANDING
NOT - NOTE, NOTES, NOTED, NOTICE, NOTIFY, NOTHING, NOTICES, NOTEBOOK, NOTEBOOKS, NOTIFICATION
PER - PAPER, SUPER, PERSON, PERIOD, PERCENT, PERFECT, PERHAPS, PERSONS, PERSONAL, PERFORMANCE
CIT - CITY, CITE, CITED, CITIES, CITIZEN, CITIZENS, CITATION, EXPLICIT, CITATIONS, CITYSEARCH
ERS - USERS, OFFERS, OTHERS, ORDERS, MEMBERS, PLAYERS, SELLERS, NUMBERS, COMPUTERS, CUSTOMERS
ERE - HERE, WERE, THERE, WHERE, SEVERE, ANYWHERE, ELSEWHERE, SOMEWHERE, ATMOSPHERE, EVERYWHERE
NGS - SONGS, RINGS, THINGS, RATINGS, SAVINGS, SPRINGS, LISTINGS, SETTINGS, MEETINGS, BUILDINGS
TED - UNITED, POSTED, LISTED, RELATED, UPDATED, LIMITED, CREATED, STARTED, LOCATED, ASSOCIATED
RAL - ORAL, RURAL, GENERAL, CENTRAL, SEVERAL, NATURAL, FEDERAL, LIBERAL, CULTURAL, AGRICULTURAL
ING - USING, BEING, RATING, DURING, LISTING, SHIPPING, SHOPPING, TRAINING, FOLLOWING, INCLUDING
ORS - DOORS, ERRORS, COLORS, AUTHORS, FACTORS, EDITORS, VISITORS, OUTDOORS, SPONSORS, DIRECTORS
VED - MOVED, LOVED, SERVED, REMOVED, RESERVED, RECEIVED, INVOLVED, APPROVED, IMPROVED, OBSERVED
LED - FILED, CALLED, FAILED, FILLED, KILLED, ENABLED, DETAILED, DISABLED, INSTALLED, CONTROLLED
SES - USES, CASES, HOUSES, COURSES, SESSION, CLASSES, RELEASES, PURPOSES, PROCESSES, BUSINESSES
OFF - OFFER, OFFICE, OFFERS, OFFERED, OFFICER, OFFICES, OFFICIAL, OFFERING, OFFICERS, OFFICIALS
CTS - ACTS, FACTS, EFFECTS, OBJECTS, ASPECTS, PRODUCTS, PROJECTS, SUBJECTS, CONTACTS, CONTRACTS
BER - NUMBER, MEMBER, BERLIN, RUBBER, OCTOBER, CHAMBER, DECEMBER, NOVEMBER, REMEMBER, SEPTEMBER
ACT - FACT, ACTION, ACTIVE, IMPACT, CONTACT, ACTIVITY, ACTUALLY, CONTRACT, ABSTRACT, ACTIVITIES
GEN - GENE, GENRE, GENDER, GENERAL, GENERIC, GENETIC, GENERATE, GENERALLY, GENERATED, GENERATION
NES - ONES, LINES, JONES, PHONES, ENGINES, MACHINES, MAGAZINES, RINGTONES, HEADLINES, GUIDELINES
REV - PREV, REVIEW, REVIEWS, REVENUE, REVISED, REVERSE, REVIEWED, REVISION, REVENUES, REVOLUTION
TOR - MOTOR, EDITOR, SECTOR, DOCTOR, FACTOR, MONITOR, TORONTO, DIRECTOR, OPERATOR, ADMINISTRATOR
NEW - NEWS, KNEW, NEWLY, NEWEST, NEWTON, NEWPORT, NEWSPAPER, NEWSLETTER, NEWSPAPERS, NEWSLETTERS
GES - AGES, PAGES, IMAGES, CHANGES, CHARGES, MESSAGES, PACKAGES, COLLEGES, LANGUAGES, CHALLENGES
SEC - SECOND, SECURE, SECTOR, SECRET, SECTION, SECONDS, SECURITY, SECTIONS, SECRETARY, SECONDARY
HIG - HIGH, HIGHS, HIGHER, HIGHLY, HIGHEST, HIGHWAY, HIGHLAND, HIGHLIGHT, HIGHLIGHTS, HIGHLIGHTED
TRY - ENTRY, TRYING, POETRY, COUNTRY, INDUSTRY, MINISTRY, REGISTRY, FORESTRY, GEOMETRY, CHEMISTRY
NED - OWNED, JOINED, SIGNED, TURNED, DEFINED, DESIGNED, RETURNED, OBTAINED, CONTAINED, DETERMINED
ANT - WANT, ANTI, PLANT, GRANT, RELEVANT, MERCHANT, IMPORTANT, ASSISTANT, RESTAURANT, SIGNIFICANT
SPE - SPEED, SPEAK, SPENT, SPEECH, SPECIAL, SPECIES, SPEAKER, SPECIFIC, SPECIFIED, SPECIFICATIONS
IAN - ASIAN, BRIAN, INDIAN, LESBIAN, RUSSIAN, ITALIAN, CANADIAN, CHRISTIAN, PHYSICIAN, AUSTRALIAN
TEM - ITEM, TEMP, STEM, SYSTEM, TEMPLE, TEMPLATE, TEMPORARY, TEMPLATES, TEMPERATURE, TEMPERATURES
SOM - SOME, SOMA, SOMEONE, SOMEHOW, SOMEWHAT, SOMEBODY, SOMERSET, SOMETHING, SOMETIMES, SOMEWHERE
NAT - NATURE, NATION, NATIVE, NATHAN, NATURAL, NATIONS, NATIONAL, NATURALS, NATURALLY, NATIONWIDE
PRO - PRODUCT, PROGRAM, PROJECT, PROFILE, PROVIDE, PROCESS, PRODUCTS, PROPERTY, PROVIDED, PROGRAMS
MAN - MANY, HUMAN, WOMAN, GERMAN, MANUAL, MANAGE, MANAGER, MANAGEMENT, MANUFACTURER, MANUFACTURING
MAI - MAIL, MAIN, MAINE, MAINLY, MAILING, MAINTAIN, MAINLAND, MAINTAINED, MAINTENANCE, MAINTAINING
CAL - CALL, LOCAL, CALLED, MEDICAL, CALENDAR, PHYSICAL, CRITICAL, TECHNICAL, POLITICAL, CALIFORNIA
BAC - BACK, BACON, BACKUP, BACKED, BACKING, BACHELOR, BACTERIA, BACTERIAL, BACKGROUND, BACKGROUNDS
COL - COLD, COLOR, COLUMN, COLOUR, COLLEGE, COLUMBIA, COLORADO, PROTOCOL, COLLECTION, COLLECTIBLES
IED - DIED, TRIED, APPLIED, MARRIED, CARRIED, MODIFIED, SUPPLIED, SPECIFIED, CERTIFIED, IDENTIFIED
CLA - CLASS, CLAIM, CLARK, CLAIMS, CLASSIC, CLASSES, CLASSICAL, CLASSROOM, CLASSIFIED, CLASSIFIEDS
PRE - PREV, PRESS, PRETTY, PRESENT, PREMIUM, PREVIOUS, PRESSURE, PRESIDENT, PRESENTED, PRESENTATION
OUT - ABOUT, OUTPUT, OUTLET, WITHOUT, OUTSIDE, OUTDOOR, CHECKOUT, OUTDOORS, THROUGHOUT, OUTSTANDING
ORY - STORY, MEMORY, THEORY, HISTORY, FACTORY, CATEGORY, ADVISORY, DIRECTORY, INVENTORY, LABORATORY
MEM - MEMO, MEMBER, MEMORY, MEMBERS, MEMPHIS, MEMORIAL, MEMORIES, MEMBRANE, MEMBERSHIP, MEMORABILIA
ICS - PICS, TOPICS, LYRICS, COMICS, PHYSICS, GRAPHICS, POLITICS, ECONOMICS, STATISTICS, ELECTRONICS
INC - INCH, INCOME, INCEST, INCLUDE, INCLUDES, INCLUDED, INCREASE, INCLUDING, INCREASED, INCREASING
DED - ADDED, ENDED, NEEDED, DECIDED, PROVIDED, INCLUDED, INTENDED, EXTENDED, DEDICATED, RECOMMENDED
STR - STREET, STRONG, STRING, STREAM, STRATEGY, STRAIGHT, STRENGTH, STRUCTURE, STRATEGIC, STRATEGIES
RES - STORES, RESULT, RESULTS, RESEARCH, RESERVED, PICTURES, FEATURES, RESOURCE, RESPONSE, RESOURCES
COM - COME, COMPANY, COMPARE, COMMENT, COMMENTS, COMPUTER, COMPLETE, COMMUNITY, COMMITTEE, COMPANIES
EXP - EXPERT, EXPECT, EXPRESS, EXPERTS, EXPLORE, EXPLAIN, EXPECTED, EXPOSURE, EXPERIENCE, EXPRESSION
ARY - MARY, JANUARY, LIBRARY, SUMMARY, PRIMARY, FEBRUARY, MILITARY, NECESSARY, SECRETARY, DICTIONARY
CES - PRICES, PLACES, FORCES, SOURCES, DEVICES, SERVICES, SCIENCES, RESOURCES, PRACTICES, REFERENCES
ADD - ADDS, ADDED, ADDING, ADDRESS, ADDITION, ADDRESSES, ADDRESSED, ADDITIONS, ADDITIONAL, ADDRESSING
DES - CODES, DESIGN, GUIDES, DESKTOP, INCLUDES, PROVIDES, DESIGNED, DESCRIBED, DESIGNATED, DESCRIPTION
ASS - PASS, MASS, CLASS, GLASS, ASSISTANT, ASSOCIATED, ASSESSMENT, ASSISTANCE, ASSOCIATES, ASSOCIATION
ALS - ALSO, DEALS, GOALS, RENTALS, ANIMALS, SPECIALS, MATERIALS, OFFICIALS, INDIVIDUALS, PROFESSIONALS
SUP - SUPER, SUPPLY, SUPPORT, SUPPLIES, SUPPLIED, SUPPORTS, SUPPLIER, SUPPORTED, SUPPLIERS, SUPPORTING
NCE - ONCE, SINCE, FRANCE, SCIENCE, FINANCE, INSURANCE, REFERENCE, EXPERIENCE, CONFERENCE, PERFORMANCE
TRA - TRACK, TRADE, EXTRA, TRAVEL, TRAFFIC, TRAINING, TRANSFER, TRADEMARKS, TRADITIONAL, TRANSPORTATION
IAL - TRIAL, SOCIAL, SPECIAL, INITIAL, OFFICIAL, MATERIAL, FINANCIAL, POTENTIAL, COMMERCIAL, INDUSTRIAL
RED - REDUCE, POWERED, OFFERED, COVERED, REQUIRED, FEATURED, COMPARED, SPONSORED, REGISTERED, CONSIDERED
APP - APPLY, APPLE, APPEAR, APPLIED, APPAREL, APPROACH, APPROVED, APPLICATION, APPROPRIATE, APPLICATIONS
LLY - FULLY, KELLY, REALLY, USUALLY, FINALLY, ACTUALLY, GENERALLY, ESPECIALLY, ORIGINALLY, AUTOMATICALLY
REP - REPLY, REPORT, REPAIR, REPORTS, REPLIES, REPUBLIC, REPORTED, REPORTING, REPLACEMENT, REPRESENTATIVE
DIS - DISC, DISPLAY, DISEASE, DISCUSS, DISTRICT, DISCOUNT, DISTANCE, DISCUSSION, DISCLAIMER, DISTRIBUTION
VES - GIVES, LIVES, MOVES, DRIVES, LEAVES, ARCHIVES, THEMSELVES, OBJECTIVES, INITIATIVES, REPRESENTATIVES
SCH - SCHOOL, SCHEME, SCHOOLS, DEUTSCH, SCHEMES, SCHEDULE, SCHEDULED, SCHEDULES, SCHOLARSHIP, SCHOLARSHIPS
PHO - PHONE, PHOTO, PHOTOS, PHONES, PHOENIX, PHOTOSHOP, PHOTOGRAPH, PHOTOGRAPHY, PHOTOGRAPHS, PHOTOGRAPHER
INT - INTO, PRINT, POINT, INTERNET, INTEREST, INTERNAL, INTERFACE, INTERESTED, INTRODUCTION, INTERNATIONAL
DIR - DIRTY, DIRECT, DIRECTOR, DIRECTLY, DIRECTED, DIRECTORY, DIRECTION, DIRECTORS, DIRECTIONS, DIRECTORIES
NTS - EVENTS, POINTS, PARENTS, COMMENTS, STUDENTS, CONTENTS, PATIENTS, DOCUMENTS, RESTAURANTS, REQUIREMENTS
REL - RELATED, RELEASE, APPAREL, RELEASES, RELEASED, RELEVANT, RELIGION, RELATIONS, RELIGIOUS, RELATIONSHIP
IES - MOVIES, SERIES, STORIES, STUDIES, POLICIES, COMPANIES, COUNTRIES, CATEGORIES, ACTIVITIES, ACCESSORIES
NAL - ANAL, FINAL, JOURNAL, NATIONAL, PERSONAL, ORIGINAL, REGIONAL, ADDITIONAL, PROFESSIONAL, INTERNATIONAL
ION - ACTION, VERSION, SECTION, MILLION, LOCATION, QUESTION, EDUCATION, INFORMATION, DESCRIPTION, APPLICATION
REC - RECENT, RECORD, RECORDS, RECEIVE, RECEIVED, RECENTLY, RECOVERY, RECOMMEND, RECOMMENDED, RECOMMENDATIONS
CON - CONTACT, CONTROL, CONTENT, CONTENTS, CONTINUE, CONSUMER, CONDITION, CONDITIONS, CONFERENCE, CONSTRUCTION
OUS - FAMOUS, VARIOUS, SERIOUS, PREVIOUS, NUMEROUS, RELIGIOUS, ANONYMOUS, DANGEROUS, CONTINUOUS, MISCELLANEOUS
DEV - DEVEL, DEVICE, DEVELOP, DEVICES, DEVELOPED, DEVELOPER, DEVELOPING, DEVELOPERS, DEVELOPMENT, DEVELOPMENTS
ENT - CURRENT, CONTENT, COMMENT, PAYMENT, DIFFERENT, EQUIPMENT, MANAGEMENT, GOVERNMENT, DEPARTMENT, DEVELOPMENT
ADV - ADVICE, ADVANCE, ADVISOR, ADVANCED, ADVISORY, ADVERTISE, ADVENTURE, ADVANTAGE, ADVERTISING, ADVERTISEMENT
ACC - ACCESS, ACCEPT, ACCOUNT, ACCEPTED, ACCOUNTS, ACCORDING, ACCOUNTING, ACCEPTANCE, ACCESSORIES, ACCOMMODATION
REG - REGION, REGULAR, REGIONS, REGISTER, REGIONAL, REGARDING, REGISTERED, REGULATION, REGULATIONS, REGISTRATION
PUB - PUBLIC, PUBMED, PUBLISH, PUBLICLY, PUBLISHED, PUBLISHER, PUBLISHING, PUBLISHERS, PUBLICATION, PUBLICATIONS
DET - DETAIL, DETAILS, DETROIT, DETAILED, DETECTED, DETERMINE, DETECTION, DETERMINED, DETERMINING, DETERMINATION
REQ - REQUEST, REQUIRE, REQUIRED, REQUIRES, REQUESTS, REQUESTED, REQUIRING, REQUESTING, REQUIREMENT, REQUIREMENTS
INF - INFO, INFANT, INFORM, INFORMED, INFLUENCE, INFECTION, INFLATION, INFORMATION, INFORMATIONAL, INFRASTRUCTURE
IMP - IMPACT, IMPORT, IMPROVE, IMPROVED, IMPORTANT, IMPLEMENT, IMPORTANCE, IMPROVEMENT, IMPLEMENTED, IMPLEMENTATION
TEC - TECH, TECHNO, SYMANTEC, TECHNICAL, TECHNIQUE, TECHNOLOGY, TECHNIQUES, TECHNICIAN, TECHNOLOGIES, TECHNOLOGICAL
ITY - CITY, QUALITY, SECURITY, ACTIVITY, COMMUNITY, AUTHORITY, UNIVERSITY, OPPORTUNITY, AVAILABILITY, RESPONSIBILITY
AUT - AUTO, AUTHOR, AUTHORS, AUTHORITY, AUTOMATIC, AUTOMOTIVE, AUTHORIZED, AUTHORITIES, AUTOMATICALLY, AUTHENTICATION
SUB - SUBMIT, SUBJECT, SUBJECTS, SUBSCRIBE, SUBMITTED, SUBSTANCE, SUBMISSION, SUBSTANCES, SUBSCRIPTION, SUBSCRIPTIONS
INS - INSIDE, INSTEAD, INSTALL, CONTAINS, INSURANCE, INSTITUTE, INSTRUMENTS, INSTRUCTIONS, INSTALLATION, INSTITUTIONS
ONS - OPTIONS, QUESTIONS, SOLUTIONS, LOCATIONS, RELATIONS, CONDITIONS, OPERATIONS, APPLICATIONS, PUBLICATIONS, COMMUNICATIONS
