IES - TECHNOLOGIES, SUPPLIES, FAMILIES, MOVIES, GALLERIES, STUDIES, COMMUNITIES
ENT - STUDENT, DIFFERENT, CONTENT, CURRENT, MANAGEMENT, DEVELOPMENT, ENVIRONMENT
ESS - REGARDLESS, SUCCESS, BUSINESS, STAINLESS, FITNESS, AWARENESS, ACCESS
INE - OFFLINE, PHENTERMINE, UKRAINE, COMBINE, PIPELINE, DETERMINE, VALENTINE
EST - SOUTHWEST, SUGGEST, BIGGEST, HIGHEST, REQUEST, OLDEST, GREATEST
TES - CERTIFICATES, CONSTITUTES, AFFILIATES, BYTES, QUOTES, WEBSITES, FAVORITES
ATE - APPROPRIATE, GRADUATE, CORPORATE, AFFILIATE, IMMEDIATE, ASSOCIATE, CERTIFICATE
ISE - LIKEWISE, CUSTOMISE, MERCHANDISE, LOUISE, FRANCHISE, OTHERWISE, ADVISE
TED - SUBMITTED, LIMITED, COMPLETED, INTERESTED, ASSOCIATED, EXPECTED, UNITED
ERS - PROVIDERS, TEACHERS, MEMBERS, NUMBERS, LETTERS, SELLERS, COMPUTERS
SES - DATABASES, ENTERPRISES, EXPENSES, BUSINESSES, DISEASES, PURPOSES, HOUSES
TER - CHARACTER, COMPUTER, NEWSLETTER, MINISTER, REGISTER, POSTER, FILTER
ING - FOLLOWING, INCLUDING, SHIPPING, BUILDING, SHOPPING, MARKETING, TRAINING
IVE - AUTOMOTIVE, DRIVE, INITIATIVE, EXCLUSIVE, POSITIVE, COMPETITIVE, EXTENSIVE
NTS - RESTAURANTS, REQUIREMENTS, ACCOUNTS, WANTS, POINTS, INSTRUMENTS, COMPONENTS
IST - COMMUNIST, PLAYLIST, CHECKLIST, NUDIST, SPECIALIST, WISHLIST, SCIENTIST
SED - FOCUSED, DISCUSSED, SUPPOSED, SURPRISED, ADDRESSED, LICENSED, MISSED
HER - PUBLISHER, PHOTOGRAPHER, CHRISTOPHER, FISHER, HIGHER, TEACHER, FURTHER
NES - PHILIPPINES, GUIDELINES, MAGAZINES, LIMOUSINES, BARNES, SCENES, MACHINES
IED - ACCOMPANIED, OCCUPIED, SUPPLIED, MARRIED, STUDIED, DENIED, APPLIED
RES - HOUSEWARES, SHARES, FIGURES, EXPENDITURES, PROSTORES, GENRES, REQUIRES
LES - COLLECTIBLES, MODULES, PRINCIPLES, VEHICLES, EXAMPLES, STYLES, ANGELES
STS - SUGGESTS, SPECIALISTS, JOURNALISTS, INTERESTS, REQUESTS, SCIENTISTS, COLUMNISTS
ION - MILLION, COMMISSION, REGION, DISCUSSION, VERSION, INFORMATION, APPLICATION
ARE - NIGHTMARE, HEALTHCARE, COMPARE, SHAKESPEARE, MEDICARE, SQUARE, DECLARE
AGE - VILLAGE, PERCENTAGE, PACKAGE, BONDAGE, LANGUAGE, HOMEPAGE, ADVANTAGE
AIN - EXPLAIN, DOMAIN, MOUNTAIN, MAINTAIN, PORCELAIN, CHAIN, AGAIN
URE - EXPOSURE, PROCEDURE, FIGURE, PRESSURE, ADVENTURE, ARCHITECTURE, TEMPERATURE
RED - SPONSORED, HUNDRED, OCCURRED, DELIVERED, COMPARED, SHARED, CONSIDERED
NED - HAPPENED, PLANNED, CONCERNED, RETURNED, MAINTAINED, OWNED, TURNED
DER - ALEXANDER, CAMCORDER, INSIDER, BUILDER, PROVIDER, MURDER, HEADER
NCE - PERFORMANCE, SEQUENCE, REFERENCE, CONFERENCE, EXPERIENCE, BALANCE, ACCEPTANCE
CES - SUBSTANCES, APPLIANCES, PLACES, DEVICES, CONFERENCES, DIFFERENCES, CHOICES
IAN - TECHNICIAN, PHYSICIAN, NORWEGIAN, EGYPTIAN, VICTORIAN, PALESTINIAN, MEDIAN
VER - VANCOUVER, WHATEVER, WHENEVER, SILVER, HARDCOVER, SAVER, MOREOVER
ANT - DEFENDANT, SIGNIFICANT, BRILLIANT, APPLICANT, MERCHANT, CONSULTANT, ASSISTANT
IAL - JUDICIAL, SUBSTANTIAL, OFFICIAL, COMMERCIAL, FINANCIAL, RESIDENTIAL, MEMORIAL
GES - COLLEGES, JUDGES, BRIDGES, CARTRIDGES, MORTGAGES, ADVANTAGES, LANGUAGES
RTS - UPSKIRTS, CONCERTS, CHARTS, STARTS, SHIRTS, EXPERTS, ALERTS
INS - SKINS, PLUGINS, HOPKINS, COLLINS, BEGINS, VITAMINS, MAINTAINS
VES - INITIATIVES, THEMSELVES, PERSPECTIVES, WAVES, INCENTIVES, ALTERNATIVES, INVOLVES
DED - PROVIDED, DIVIDED, AWARDED, DOWNLOADED, INCLUDED, EMBEDDED, RECOMMENDED
ECT - ARCHITECT, SUBJECT, INDIRECT, INCORRECT, CONNECT, AFFECT, SUSPECT
BLE - FLEXIBLE, ELIGIBLE, AFFORDABLE, DOUBLE, COMPATIBLE, TROUBLE, RESPONSIBLE
NER - COMMISSIONER, DESIGNER, CLEANER, CONTAINER, BURNER, PARTNER, OWNER
NAL - JOURNAL, EXTERNAL, SIGNAL, INTERNAL, PROFESSIONAL, CONVENTIONAL, PERSONAL
ITY - OPPORTUNITY, COMMUNITY, AVAILABILITY, CAPACITY, IDENTITY, CELEBRITY, MAJORITY
AND - BROADBAND, COMMAND, CLEVELAND, THOUSAND, UNDERSTAND, HUSBAND, SWITZERLAND
NDS - NETHERLANDS, DEPENDS, COMMANDS, THOUSANDS, FRIENDS, SECONDS, GROUNDS
VED - INVOLVED, SHAVED, BELIEVED, ACHIEVED, RETRIEVED, OBSERVED, IMPROVED
GHT - COPYRIGHT, CAUGHT, THOUGHT, BROUGHT, BOUGHT, TAUGHT, INSIGHT
ONS - PERSONS, REASONS, DISCUSSIONS, INSTITUTIONS, OPINIONS, CONDITIONS, APPLICATIONS
TAL - DIGITAL, FUNDAMENTAL, CRYSTAL, INSTRUMENTAL, FATAL, EXPERIMENTAL, HORIZONTAL
ICS - DYNAMICS, STATISTICS, MATHEMATICS, GRAPHICS, PHYSICS, LYRICS, BASICS
LED - SCHEDULED, CONTROLLED, REVEALED, COMPILED, HANDLED, PULLED, ENROLLED
ARD - STANDARD, MASTERCARD, PACKARD, BOULEVARD, KEYBOARD, RICHARD, GUARD
ALS - INDIVIDUALS, PROPOSALS, OFFICIALS, CHEMICALS, JOURNALS, PERIPHERALS, TESTIMONIALS
NGS - BUILDINGS, THONGS, PROCEEDINGS, SONGS, FINDINGS, RECORDINGS, WEDDINGS
RAL - BEHAVIORAL, STRUCTURAL, AGRICULTURAL, CATHEDRAL, REFERRAL, FLORAL, MORAL
GER - BLOGGER, MESSENGER, PASSENGER, CHARGER, KRUGER, BIGGER, YOUNGER
TIC - DEMOCRATIC, THERAPEUTIC, GENETIC, CELTIC, PLASTIC, DIAGNOSTIC, REALISTIC
KED - CHECKED, WORKED, ATTACKED, FUCKED, MARKED, LOOKED, LINKED
CAL - BIOLOGICAL, LOCAL, STATISTICAL, MECHANICAL, CLASSICAL, MEDICAL, MUSICAL
SON - THOMPSON, JEFFERSON, JOHNSON, JACKSON, ROBINSON, WILSON, SIMPSON
ARY - ANNIVERSARY, GLOSSARY, HUNGARY, JANUARY, CONTEMPORARY, FEBRUARY, NECESSARY
TOR - CALCULATOR, VISITOR, INSTRUCTOR, INVESTOR, COORDINATOR, MONITOR, GENERATOR
ORS - SPONSORS, ERRORS, SENIORS, VENDORS, COLORS, AUTHORS, INVESTORS
TON - DAYTON, BUTTON, WELLINGTON, COTTON, HAMPTON, CHARLESTON, NEWTON
OUS - FABULOUS, HAZARDOUS, ANONYMOUS, TREMENDOUS, CONTINUOUS, FAMOUS, INDIGENOUS
ELY - DEFINITELY, ABSOLUTELY, WIDELY, IMMEDIATELY, EFFECTIVELY, CLOSELY, EXTREMELY
TLY - SLIGHTLY, MOSTLY, SUBSEQUENTLY, EXPLICITLY, INSTANTLY, SHORTLY, EFFICIENTLY
LLY - SUCCESSFULLY, BILLY, KELLY, ORIGINALLY, FULLY, CAREFULLY, NORMALLY
CKS - PAPERBACKS, TRACKBACKS, ATTACKS, CHECKS, SUCKS, DICKS, CHICKS
ORY - ACCESSORY, LABORATORY, GLORY, MEMORY, ADVISORY, MANDATORY, STATUTORY
