SEE - SEEN, SEEM, SEEK, SEED, SEEMS, SEEDS, SEEING, SEEMED, SEEKER, SEEKING
FIL - FILE, FILM, FILL, FILES, FILMS, FILED, FILTER, FILLED, FILING, FILTERS
SHO - SHOW, SHOP, SHOT, SHORT, SHOWS, SHOES, SHOWN, SHOULD, SHOWING, SHOPPING
HEL - HELP, HELD, HELL, HELLO, HELPS, HELEN, HELPED, HELENA, HELPFUL, HELPING
CAR - CARE, CARD, CART, CARS, CARDS, CARRY, CAREER, CAREERS, CARRIED, CAROLINA
DEA - DEAL, DEAD, DEAN, DEAR, DEALS, DEATH, DEALER, DEALERS, DEALING, DEADLINE
THI - THIS, THIN, THINK, THING, THIRD, THICK, THINGS, THIRTY, THINKS, THINKING
LIN - LINE, LINK, LINKS, LINUX, LINES, LINDA, LINEAR, LINKED, LINCOLN, LINGERIE
STO - STOP, STORE, STOCK, STORY, STONE, STORM, STORES, STOCKS, STORIES, STORAGE
GRE - GREY, GREG, GREW, GREAT, GREEN, GREEK, GREECE, GREATER, GREATLY, GREATEST
SAL - SALE, SALT, SALES, SALON, SALEM, SALAD, SALARY, SALMON, SALVADOR, SALARIES
RAT - RATE, RATS, RATES, RATED, RATIO, RATING, RATHER, RATIOS, RATINGS, RATIONAL
HEA - HEAD, HEAR, HEAT, HEART, HEARD, HEAVY, HEALTH, HEARING, HEALTHY, HEADLINES
WIN - WINE, WIND, WING, WINGS, WINDOW, WINTER, WINNER, WINDOWS, WINNING, WINNERS
FEE - FEEL, FEED, FEET, FEES, FEEDS, FEELS, FEELING, FEEDING, FEEDBACK, FEELINGS
SPA - SPAM, SPAN, SPACE, SPAIN, SPARE, SPARC, SPACES, SPANISH, SPATIAL, SPANKING
GRO - GROW, GROUP, GROSS, GROVE, GROWN, GROUPS, GROWTH, GROUND, GROWING, GROUNDS
LAT - LATE, LATER, LATIN, LATEX, LATEST, LATINA, LATTER, LATVIA, LATINO, LATINAS
PLA - PLAN, PLAY, PLACE, PLANS, PLANT, PLAYER, PLACES, PLAYERS, PLAYING, PLANNING
BOO - BOOK, BOOT, BOOKS, BOOBS, BOOTS, BOOTY, BOOST, BOOKING, BOOKMARK, BOOKSTORE
BLO - BLOG, BLOW, BLOOD, BLOCK, BLOGS, BLONDE, BLOCKS, BLOWJOB, BLOGGER, BLOWJOBS
REA - READ, REAL, READY, REACH, REALLY, REASON, READER, READING, REASONS, READERS
CAS - CASE, CASH, CAST, CASES, CASINO, CASTLE, CASUAL, CASINOS, CASTING, CASSETTE
WOR - WORK, WORD, WORLD, WORKS, WORDS, WORTH, WORKED, WORKING, WORKERS, WORLDWIDE
FOR - FORM, FORUM, FORCE, FORMS, FORUMS, FORMAT, FORMER, FOREST, FOREIGN, FORWARD
BEA - BEAR, BEAT, BEAM, BEACH, BEARS, BEAST, BEADS, BEAUTY, BEAUTIFUL, BEASTIALITY
CHI - CHIP, CHINA, CHILD, CHIEF, CHILE, CHIPS, CHICAGO, CHINESE, CHICKEN, CHILDREN
SHI - SHIP, SHIT, SHIPS, SHIRT, SHIFT, SHIRTS, SHIELD, SHIPPED, SHIPPING, SHIPMENT
HER - HERE, HERO, HERBS, HEREIN, HERALD, HEROES, HERBAL, HEREBY, HERSELF, HERITAGE
BRA - BRAD, BRAND, BRAIN, BRASS, BRAKE, BRANDS, BRANCH, BRAZIL, BRACELET, BRANCHES
STE - STEP, STEEL, STEVE, STEPS, STEAM, STEREO, STEVEN, STEPHEN, STEWART, STERLING
SOL - SOLD, SOLO, SOLE, SOLID, SOLAR, SOLVE, SOLELY, SOLUTION, SOLDIERS, SOLUTIONS
BLA - BLAH, BLACK, BLANK, BLADE, BLAIR, BLAST, BLAME, BLACKS, BLACKJACK, BLACKBERRY
SEA - SEAT, SEAL, SEAN, SEATS, SEARCH, SEASON, SEALED, SEATTLE, SEARCHES, SEARCHING
TRI - TRIP, TRIM, TRIAL, TRIED, TRIPS, TRIALS, TRIPLE, TRICKS, TRIBUNE, TRIPADVISOR
THE - THEY, THEM, THEN, THEIR, THERE, THESE, THEORY, THERAPY, THEREFORE, THEMSELVES
FLO - FLOW, FLOOR, FLOOD, FLOWS, FLOWER, FLORAL, FLORIDA, FLOWERS, FLORIST, FLORISTS
HOL - HOLD, HOLE, HOLY, HOLDS, HOLDEM, HOLDER, HOLIDAY, HOLDING, HOLIDAYS, HOLLYWOOD
LOG - LOGO, LOGS, LOGIN, LOGIC, LOGOS, LOGGED, LOGICAL, LOGGING, LOGITECH, LOGISTICS
SHA - SHALL, SHARE, SHAPE, SHARP, SHARED, SHARES, SHAVED, SHADOW, SHARING, SHAREWARE
FIR - FIRE, FIRM, FIRST, FIRMS, FIRED, FIRES, FIREFOX, FIREWALL, FIREWIRE, FIREPLACE
STA - STAR, STAY, STATE, START, STAFF, STATES, STATUS, STANDARD, STATEMENT, STANDARDS
MIL - MILF, MILE, MILK, MILES, MILFS, MILLER, MILLION, MILITARY, MILLIONS, MILFHUNTER
PRI - PRICE, PRINT, PRIOR, PRIME, PRICES, PRIVACY, PRIVATE, PRINTER, PRIMARY, PRICING
DRI - DRIVE, DRINK, DRILL, DRIVER, DRIVES, DRIVEN, DRINKS, DRIVING, DRIVERS, DRINKING
TRE - TREE, TREK, TREES, TREAT, TREND, TRENDS, TREMBL, TREATED, TREATMENT, TREATMENTS
GRA - GRAY, GRAND, GRADE, GRANT, GRATIS, GRANTS, GRAPHIC, GRANTED, GRAPHICS, GRADUATE
PIC - PICS, PICK, PICKS, PICKED, PICKUP, PICNIC, PICTURE, PICKING, PICTURES, PICHUNTER
BEL - BELL, BELT, BELOW, BELIEF, BELONG, BELIEVE, BELGIUM, BELIEFS, BELIEVED, BELIEVES
CLO - CLOSE, CLOCK, CLOUD, CLOSED, CLOSER, CLOUDY, CLOTHES, CLOSING, CLOSELY, CLOTHING
PAR - PART, PARK, PARTY, PARTS, PARIS, PARENTS, PARTNER, PARTIES, PARTNERS, PARTICULAR
BRI - BRING, BRIEF, BRIAN, BRIDGE, BRIGHT, BRINGS, BRITISH, BRITAIN, BRISTOL, BRINGING
MIN - MIND, MINI, MINE, MINOR, MINUTE, MINUTES, MINIMUM, MINISTER, MINISTRY, MINNESOTA
WAT - WATT, WATER, WATCH, WATTS, WATERS, WATSON, WATCHES, WATCHED, WATCHING, WATERSHED
SEN - SEND, SENT, SENSE, SENIOR, SENATE, SENSOR, SENDING, SENATOR, SENTENCE, SENSITIVE
MOD - MODE, MODEL, MODEM, MODELS, MODERN, MODULE, MODIFY, MODULES, MODIFIED, MODERATOR
BAS - BASE, BASS, BASED, BASIC, BASIS, BASKET, BASKETS, BASEBALL, BASICALLY, BASKETBALL
PAC - PACK, PACE, PACKS, PACKET, PACKED, PACKAGE, PACIFIC, PACKARD, PACKAGES, PACKAGING
FAC - FACT, FACE, FACTS, FACES, FACTOR, FACULTY, FACTORS, FACTORY, FACILITY, FACILITIES
LEA - LEAD, LEARN, LEAST, LEAVE, LEAGUE, LEADER, LEADING, LEATHER, LEARNING, LEADERSHIP
CLI - CLIP, CLICK, CLIPS, CLIENT, CLINIC, CLIENTS, CLIMATE, CLINTON, CLINICAL, CLICKING
MAR - MARK, MARY, MARCH, MARKET, MARTIN, MARINE, MARKETS, MARYLAND, MARRIAGE, MARKETING
FOL - FOLK, FOLD, FOLKS, FOLLOW, FOLDER, FOLLOWS, FOLDERS, FOLDING, FOLLOWED, FOLLOWING
SPO - SPOT, SPORT, SPOKE, SPOTS, SPORTS, SPOKEN, SPONSOR, SPORTING, SPONSORS, SPONSORED
HAN - HAND, HANG, HANDS, HANDLE, HANDED, HANGING, HANDJOB, HANDLING, HANDBOOK, HANDHELD
COU - COULD, COURT, COUNT, COUNTY, COURSE, COUPLE, COUNTRY, COUNCIL, COURSES, COUNTRIES
VIS - VISA, VISIT, VISUAL, VISION, VISITS, VISITOR, VISIBLE, VISITED, VISITORS, VISITING
BAN - BANK, BAND, BANG, BANKS, BANDS, BANNER, BANKING, BANDWIDTH, BANKRUPTCY, BANGLADESH
CEN - CENT, CENTS, CENTER, CENTRE, CENSUS, CENTRAL, CENTURY, CENTERS, CENTRES, CENTURIES
PAT - PATH, PATCH, PATHS, PATENT, PATIENT, PATTERN, PATRICK, PATCHES, PATIENTS, PATTERNS
CRE - CREW, CREEK, CREAM, CREDIT, CREATE, CREATED, CREDITS, CREATIVE, CREATING, CREATION
POR - PORN, PORT, PORNO, PORTS, PORTAL, PORTION, PORTABLE, PORTLAND, PORTUGAL, PORTFOLIO
LAN - LAND, LANE, LANG, LANDS, LANKA, LANDING, LANGUAGE, LANGUAGES, LANDSCAPE, LANCASTER
SOU - SOUL, SOUTH, SOUND, SOURCE, SOUNDS, SOUGHT, SOURCES, SOUTHERN, SOUTHWEST, SOUTHEAST
LOC - LOCK, LOCAL, LOCATE, LOCKED, LOCALE, LOCATED, LOCATOR, LOCALLY, LOCATION, LOCATIONS
DEL - DELL, DELTA, DELAY, DELETE, DELUXE, DELIVER, DELETED, DELIVERY, DELAWARE, DELIVERED
SEL - SELL, SELF, SELLS, SELECT, SELLER, SELLERS, SELLING, SELECTED, SELECTION, SELECTING
POS - POST, POSTS, POSTED, POSTER, POSTAL, POSTERS, POSTING, POSSIBLE, POSITION, POSITIVE
HAR - HARD, HARM, HARRY, HARRIS, HARBOR, HARVARD, HARDWARE, HARDCORE, HARRISON, HARDCOVER
GUI - GUIDE, GUILD, GUIDES, GUITAR, GUINEA, GUILTY, GUIDED, GUITARS, GUIDANCE, GUIDELINES
WIL - WILL, WILD, WILEY, WILSON, WILLOW, WILLIAM, WILLING, WILLIAMS, WILDLIFE, WILDERNESS
MUS - MUST, MUSIC, MUSEUM, MUSCLE, MUSLIM, MUSICAL, MUSEUMS, MUSLIMS, MUSICIAN, MUSICIANS
SER - SERVE, SERIES, SERVER, SERVED, SERIAL, SERVICE, SERVERS, SERIOUS, SERVING, SERVICES
THR - THRU, THREE, THROW, THREAD, THREAT, THROAT, THROUGH, THREADS, THRESHOLD, THROUGHOUT
ACT - ACTS, ACTOR, ACTION, ACTIVE, ACTUAL, ACTING, ACTIONS, ACTIVITY, ACTUALLY, ACTIVITIES
QUE - QUEEN, QUERY, QUEST, QUEUE, QUEBEC, QUEENS, QUERIES, QUESTION, QUESTIONS, QUEENSLAND
MAT - MATH, MATCH, MATURE, MATTER, MATRIX, MATTERS, MATCHES, MATERIAL, MATCHING, MATERIALS
STU - STUDY, STUFF, STUDIO, STUPID, STUDENT, STUDIES, STUDIOS, STUDIED, STUDENTS, STUDYING
PAS - PAST, PASS, PASSED, PASSES, PASSING, PASSION, PASSAGE, PASSWORD, PASSPORT, PASSENGER
CHA - CHAT, CHANGE, CHARGE, CHANCE, CHANGES, CHAPTER, CHANNEL, CHANGED, CHARLES, CHARACTER
FIN - FIND, FINE, FINAL, FINISH, FINANCE, FINALLY, FINDING, FINISHED, FINANCIAL, FINANCING
CAN - CANON, CANDY, CANADA, CANCER, CANCEL, CANYON, CANVAS, CANADIAN, CANDIDATE, CANDIDATES
POL - POLL, POLLS, POLICY, POLICE, POLAND, POLISH, POLICIES, POLITICS, POLITICAL, POLLUTION
THO - THOU, THOSE, THOUGH, THOMAS, THONGS, THOUGHT, THOUGHTS, THOUSAND, THOMPSON, THOUSANDS
EVE - EVEN, EVER, EVERY, EVENT, EVENTS, EVENING, EVERYONE, EVERYDAY, EVERYTHING, EVENTUALLY
FOU - FOUR, FOUL, FOUND, FOURTH, FOUGHT, FOUNDED, FOUNDER, FOUNTAIN, FOUNDATION, FOUNDATIONS
FRE - FREE, FRED, FRESH, FRENCH, FREEDOM, FREIGHT, FREEWARE, FREQUENT, FREQUENCY, FREQUENTLY
CHE - CHECK, CHEAP, CHEATS, CHECKS, CHEESE, CHECKED, CHEMICAL, CHECKOUT, CHECKING, CHEMISTRY
CAM - CAME, CAMP, CAMERA, CAMPUS, CAMERAS, CAMPING, CAMPAIGN, CAMPBELL, CAMBRIDGE, CAMCORDER
MON - MONEY, MONTH, MONTHS, MONDAY, MONTHLY, MONITOR, MONTANA, MONSTER, MONITORS, MONITORING
VIE - VIEW, VIEWS, VIEWED, VIEWER, VIENNA, VIEWING, VIETNAM, VIEWERS, VIETNAMESE, VIEWPICTURE
NOT - NOTE, NOTES, NOTED, NOTICE, NOTIFY, NOTHING, NOTICES, NOTEBOOK, NOTEBOOKS, NOTIFICATION
BRO - BROWN, BROAD, BROWSE, BROKEN, BROWSER, BROUGHT, BROTHER, BROTHERS, BROADBAND, BROADCAST
VAL - VALUE, VALID, VALVE, VALUES, VALLEY, VALIUM, VALUABLE, VALENTINE, VALUATION, VALIDATION
UNI - UNIT, UNIX, UNION, UNITS, UNITED, UNIQUE, UNIVERSE, UNIVERSAL, UNIVERSITY, UNIVERSITIES
HOU - HOUR, HOUSE, HOURS, HOUSES, HOURLY, HOUSING, HOUSTON, HOUSEHOLD, HOUSEWARES, HOUSEHOLDS
MOR - MORE, MORAL, MORGAN, MORRIS, MORNING, MOROCCO, MORTGAGE, MOREOVER, MORTGAGES, MORTALITY
FRA - FRAME, FRANK, FRAUD, FRANCE, FRAMES, FRANCIS, FRANKLIN, FRANCISCO, FRAMEWORK, FRANCHISE
NOR - NORTH, NORMAL, NORWAY, NORTON, NORMAN, NORFOLK, NORTHERN, NORMALLY, NORTHWEST, NORTHEAST
MET - META, METAL, METER, METRO, METHOD, METERS, METHODS, METABOLISM, METHODOLOGY, METROPOLITAN
MEA - MEAN, MEAT, MEANS, MEANT, MEASURE, MEANING, MEASURES, MEASURED, MEASUREMENT, MEASUREMENTS
SIG - SIGN, SIGNS, SIGHT, SIGMA, SIGNED, SIGNAL, SIGNALS, SIGNATURE, SIGNIFICANT, SIGNIFICANTLY
OFF - OFFER, OFFICE, OFFERS, OFFERED, OFFICER, OFFICES, OFFICIAL, OFFERING, OFFICERS, OFFICIALS
REM - REMOTE, REMOVE, REMAIN, REMOVED, REMOVAL, REMAINS, REMARKS, REMEMBER, REMAINED, REMAINING
ART - ARTS, ARTIST, ARTHUR, ARTICLE, ARTISTS, ARTWORK, ARTICLES, ARTISTIC, ARTHRITIS, ARTIFICIAL
CIT - CITY, CITE, CITED, CITIES, CITIZEN, CITIZENS, CITATION, CITATIONS, CITYSEARCH, CITIZENSHIP
SEC - SECOND, SECURE, SECTOR, SECRET, SECTION, SECONDS, SECURITY, SECTIONS, SECRETARY, SECONDARY
CUR - CURE, CURVE, CURTIS, CURVES, CURRENT, CURIOUS, CURRENCY, CURRENTLY, CURRICULUM, CURRENCIES
REF - REFER, REFORM, REFUND, REFINE, REFERS, REFLECT, REFERRED, REFERENCE, REFINANCE, REFERENCES
GEN - GENE, GENRE, GENDER, GENERAL, GENERIC, GENETIC, GENERATE, GENERALLY, GENERATED, GENERATION
COL - COLD, COLOR, COLUMN, COLOUR, COLORS, COLLEGE, COLUMBIA, COLORADO, COLLECTION, COLLECTIBLES
EDI - EDIT, EDITOR, EDITED, EDITION, EDITORS, EDITING, EDITIONS, EDITORIAL, EDINBURGH, EDITORIALS
SOM - SOME, SOMA, SOMEONE, SOMEHOW, SOMEWHAT, SOMEBODY, SOMERSET, SOMETHING, SOMETIMES, SOMEWHERE
SPE - SPEED, SPEAK, SPENT, SPEECH, SPECIAL, SPECIES, SPEAKER, SPECIFIC, SPECIFIED, SPECIFICATIONS
NAT - NATURE, NATION, NATIVE, NATHAN, NATURAL, NATIONS, NATIONAL, NATURALS, NATURALLY, NATIONWIDE
HIG - HIGH, HIGHS, HIGHER, HIGHLY, HIGHEST, HIGHWAY, HIGHLAND, HIGHLIGHT, HIGHLIGHTS, HIGHLIGHTED
EXT - EXTRA, EXTENT, EXTEND, EXTRAS, EXTREME, EXTERNAL, EXTENDED, EXTENSION, EXTREMELY, EXTENSIVE
CLA - CLASS, CLAIM, CLARK, CLAIMS, CLASSIC, CLASSES, CLASSICAL, CLASSROOM, CLASSIFIED, CLASSIFIEDS
BAC - BACK, BACON, BACKUP, BACKED, BACKING, BACHELOR, BACTERIA, BACTERIAL, BACKGROUND, BACKGROUNDS
DEC - DECK, DECOR, DECIDE, DECIDED, DECEMBER, DECISION, DECREASE, DECLARED, DECISIONS, DECLARATION
OUT - OUTPUT, OUTLET, OUTSIDE, OUTDOOR, OUTLOOK, OUTCOME, OUTLINE, OUTDOORS, OUTCOMES, OUTSTANDING
MAI - MAIL, MAIN, MAINE, MAINLY, MAILING, MAINTAIN, MAINLAND, MAINTAINED, MAINTENANCE, MAINTAINING
SUR - SURE, SURF, SURVEY, SURFACE, SURGERY, SURVEYS, SURPRISE, SURVIVAL, SURROUNDING, SURVEILLANCE
CAT - CATS, CATCH, CATTLE, CATALOG, CATEGORY, CATHOLIC, CATERING, CATALOGUE, CATHERINE, CATEGORIES
OPE - OPEN, OPERA, OPENED, OPENING, OPERATE, OPERATOR, OPERATING, OPERATION, OPERATORS, OPERATIONS
PRO - PRODUCT, PROGRAM, PROJECT, PROFILE, PROVIDE, PROCESS, PRODUCTS, PROPERTY, PROVIDED, PROGRAMS
INC - INCH, INCOME, INCEST, INCLUDE, INCLUDES, INCLUDED, INCREASE, INCLUDING, INCREASED, INCREASING
WEB - WEBLOG, WEBCAM, WEBSITE, WEBSTER, WEBLOGS, WEBCAMS, WEBSITES, WEBSHOTS, WEBMASTER, WEBMASTERS
PUR - PURE, PURPLE, PURSUE, PURPOSE, PURCHASE, PURPOSES, PURSUANT, PURCHASED, PURCHASES, PURCHASING
PRE - PREV, PRESS, PRETTY, PRESENT, PREMIUM, PREVIOUS, PRESSURE, PRESIDENT, PRESENTED, PRESENTATION
MEM - MEMO, MEMBER, MEMORY, MEMBERS, MEMPHIS, MEMORIAL, MEMORIES, MEMBRANE, MEMBERSHIP, MEMORABILIA
EXP - EXPERT, EXPECT, EXPRESS, EXPERTS, EXPLORE, EXPLAIN, EXPECTED, EXPOSURE, EXPERIENCE, EXPRESSION
MED - MEDIA, MEDIUM, MEDIAN, MEDICAL, MEDLINE, MEDICINE, MEDICARE, MEDIEVAL, MEDICATION, MEDICATIONS
COM - COME, COMPANY, COMPARE, COMMENT, COMMENTS, COMPUTER, COMPLETE, COMMUNITY, COMMITTEE, COMPANIES
REV - REVIEW, REVIEWS, REVENUE, REVISED, REVERSE, REVIEWED, REVISION, REVENUES, REVEALED, REVOLUTION
STR - STREET, STRONG, STRING, STREAM, STRATEGY, STRAIGHT, STRENGTH, STRUCTURE, STRATEGIC, STRATEGIES
EXC - EXCEL, EXCEPT, EXCESS, EXCEED, EXCHANGE, EXCITING, EXCELLENT, EXCLUSIVE, EXCEPTION, EXCELLENCE
ADD - ADDS, ADDED, ADDING, ADDRESS, ADDITION, ADDRESSES, ADDRESSED, ADDITIONS, ADDITIONAL, ADDRESSING
EMP - EMPTY, EMPIRE, EMPLOY, EMPLOYEE, EMPLOYER, EMPLOYED, EMPHASIS, EMPLOYEES, EMPLOYERS, EMPLOYMENT
VER - VERY, VERIFY, VERSUS, VERSION, VERMONT, VERSIONS, VERTICAL, VERIFIED, VERZEICHNIS, VERIFICATION
NEW - NEWS, NEWLY, NEWEST, NEWTON, NEWPORT, NEWSPAPER, NEWCASTLE, NEWSLETTER, NEWSPAPERS, NEWSLETTERS
TER - TERM, TERMS, TERRY, TERROR, TERMINAL, TERRITORY, TERRORISM, TERRORIST, TERRITORIES, TERMINATION
ENT - ENTER, ENTRY, ENTIRE, ENTITY, ENTRIES, ENTERED, ENTITLED, ENTERPRISE, ENTERPRISES, ENTERTAINMENT
PER - PERSON, PERIOD, PERCENT, PERFECT, PERHAPS, PERSONS, PERSONAL, PERSONNEL, PERMISSION, PERFORMANCE
FUN - FUND, FUNDS, FUNNY, FUNDED, FUNDING, FUNCTION, FUNCTIONS, FUNCTIONAL, FUNDAMENTAL, FUNCTIONALITY
SUP - SUPER, SUPPLY, SUPPORT, SUPPLIES, SUPPLIED, SUPPORTS, SUPPLIER, SUPPORTED, SUPPLIERS, SUPPORTING
ENG - ENGINE, ENGAGE, ENGLISH, ENGLAND, ENGINES, ENGAGED, ENGINEER, ENGINEERS, ENGAGEMENT, ENGINEERING
CAL - CALL, CALLS, CALLED, CALLING, CALENDAR, CALCULATE, CALENDARS, CALIFORNIA, CALCULATOR, CALCULATED
SIM - SIMS, SIMON, SIMPLE, SIMPLY, SIMILAR, SIMPSON, SIMILARLY, SIMULATION, SIMPLIFIED, SIMULTANEOUSLY
RET - RETURN, RETAIL, RETURNS, RETIRED, RETURNED, RETAILER, RETURNING, RETAILERS, RETENTION, RETIREMENT
APP - APPLY, APPLE, APPEAR, APPLIED, APPAREL, APPROACH, APPROVED, APPLICATION, APPROPRIATE, APPLICATIONS
DIS - DISC, DISPLAY, DISEASE, DISCUSS, DISTRICT, DISCOUNT, DISTANCE, DISCUSSION, DISCLAIMER, DISTRIBUTION
DES - DESK, DESIGN, DESKTOP, DESIGNS, DESIGNED, DESIGNER, DESCRIBED, DESIGNATED, DESCRIPTION, DESTINATION
DEF - DEFINE, DEFAULT, DEFINED, DEFENSE, DEFENCE, DEFINES, DEFENDANT, DEFINITION, DEFINITELY, DEFINITIONS
ATT - ATTACK, ATTEND, ATTEMPT, ATTACKS, ATTORNEY, ATTACHED, ATTENTION, ATTORNEYS, ATTACHMENT, ATTRACTIONS
REP - REPLY, REPORT, REPAIR, REPORTS, REPLIES, REPUBLIC, REPORTED, REPORTING, REPLACEMENT, REPRESENTATIVE
PHO - PHONE, PHOTO, PHOTOS, PHONES, PHOENIX, PHOTOSHOP, PHOTOGRAPH, PHOTOGRAPHY, PHOTOGRAPHS, PHOTOGRAPHER
DEP - DEPTH, DEPUTY, DEPOSIT, DEPENDS, DEPENDING, DEPENDENT, DEPARTURE, DEPARTMENT, DEPRESSION, DEPARTMENTS
DIR - DIRTY, DIRECT, DIRECTOR, DIRECTLY, DIRECTED, DIRECTORY, DIRECTION, DIRECTORS, DIRECTIONS, DIRECTORIES
IND - INDEX, INDIA, INDIAN, INDIANA, INDUSTRY, INDIVIDUAL, INDUSTRIAL, INDUSTRIES, INDEPENDENT, INDIVIDUALS
TRA - TRACK, TRADE, TRAVEL, TRAFFIC, TRAINING, TRANSFER, TRANSPORT, TRADEMARKS, TRADITIONAL, TRANSPORTATION
COR - CORE, CORP, CORNER, CORRECT, CORPORATE, CORRECTLY, CORRECTION, CORPORATION, CORRECTIONS, CORRESPONDING
MAN - MANY, MANUAL, MANAGE, MANNER, MANAGER, MANAGED, MANAGEMENT, MANUFACTURER, MANUFACTURING, MANUFACTURERS
REC - RECENT, RECORD, RECORDS, RECEIVE, RECEIVED, RECENTLY, RECOVERY, RECOMMEND, RECOMMENDED, RECOMMENDATIONS
SCH - SCHOOL, SCHEME, SCHOOLS, SCHEMES, SCHEDULE, SCHEDULED, SCHEDULES, SCHEDULING, SCHOLARSHIP, SCHOLARSHIPS
CON - CONTACT, CONTROL, CONTENT, CONTENTS, CONTINUE, CONSUMER, CONDITION, CONDITIONS, CONFERENCE, CONSTRUCTION
DEV - DEVEL, DEVICE, DEVELOP, DEVICES, DEVELOPED, DEVELOPER, DEVELOPING, DEVELOPERS, DEVELOPMENT, DEVELOPMENTS
QUA - QUALITY, QUARTER, QUANTUM, QUALIFY, QUANTITY, QUARTERS, QUALIFIED, QUARTERLY, QUANTITIES, QUALIFICATIONS
ADV - ADVICE, ADVANCE, ADVISOR, ADVANCED, ADVISORY, ADVERTISE, ADVENTURE, ADVANTAGE, ADVERTISING, ADVERTISEMENT
PUB - PUBLIC, PUBMED, PUBLISH, PUBLICLY, PUBLISHED, PUBLISHER, PUBLISHING, PUBLISHERS, PUBLICATION, PUBLICATIONS
REG - REGION, REGULAR, REGIONS, REGISTER, REGIONAL, REGARDING, REGISTERED, REGULATION, REGULATIONS, REGISTRATION
ACC - ACCESS, ACCEPT, ACCOUNT, ACCEPTED, ACCOUNTS, ACCORDING, ACCOUNTING, ACCEPTANCE, ACCESSORIES, ACCOMMODATION
DET - DETAIL, DETAILS, DETROIT, DETAILED, DETECTED, DETERMINE, DETECTION, DETERMINED, DETERMINING, DETERMINATION
ELE - ELEMENT, ELECTED, ELECTRIC, ELEMENTS, ELECTION, ELECTIONS, ELECTRONIC, ELECTRICAL, ELEMENTARY, ELECTRONICS
REQ - REQUEST, REQUIRE, REQUIRED, REQUIRES, REQUESTS, REQUESTED, REQUIRING, REQUESTING, REQUIREMENT, REQUIREMENTS
REL - RELATED, RELEASE, RELEASES, RELEASED, RELEVANT, RELIGION, RELATIONS, RELIGIOUS, RELATIONSHIP, RELATIONSHIPS
INF - INFO, INFANT, INFORM, INFORMED, INFLUENCE, INFECTION, INFLATION, INFORMATION, INFORMATIONAL, INFRASTRUCTURE
ASS - ASSETS, ASSIST, ASSEMBLY, ASSISTANT, ASSOCIATE, ASSOCIATED, ASSESSMENT, ASSISTANCE, ASSOCIATES, ASSOCIATION
EFF - EFFECT, EFFORT, EFFECTS, EFFORTS, EFFECTIVE, EFFICIENT, EFFICIENCY, EFFECTIVELY, EFFICIENTLY, EFFECTIVENESS
RES - RESULT, RESULTS, RESEARCH, RESERVED, RESOURCE, RESPONSE, RESOURCES, RESPONSIBLE, RESTAURANTS, RESPONSIBILITY
EST - ESTATE, ESTONIA, ESTATES, ESTIMATE, ESTIMATED, ESTIMATES, ESTABLISH, ESTABLISHED, ESTABLISHING, ESTABLISHMENT
IMP - IMPACT, IMPORT, IMPROVE, IMPROVED, IMPORTANT, IMPLEMENT, IMPORTANCE, IMPROVEMENT, IMPLEMENTED, IMPLEMENTATION
INT - INTO, INTERNET, INTEREST, INTERNAL, INTERFACE, INTERESTS, INTERESTED, INTERESTING, INTRODUCTION, INTERNATIONAL
AUT - AUTO, AUTHOR, AUTHORS, AUTHORITY, AUTOMATIC, AUTOMOTIVE, AUTHORIZED, AUTHORITIES, AUTOMATICALLY, AUTHENTICATION
SUB - SUBMIT, SUBJECT, SUBJECTS, SUBSCRIBE, SUBMITTED, SUBSTANCE, SUBMISSION, SUBSTANCES, SUBSCRIPTION, SUBSCRIPTIONS
DIF - DIFF, DIFFER, DIFFERENT, DIFFICULT, DIFFERENCE, DIFFICULTY, DIFFERENCES, DIFFERENTLY, DIFFICULTIES, DIFFERENTIAL
INS - INSIDE, INSTEAD, INSTALL, INSURANCE, INSTITUTE, INSTALLED, INSTRUMENTS, INSTRUCTIONS, INSTALLATION, INSTITUTIONS
TEC - TECH, TECHNO, TECHNICAL, TECHNIQUE, TECHNOLOGY, TECHNIQUES, TECHNICIAN, TECHNOLOGIES, TECHREPUBLIC, TECHNOLOGICAL
INV - INVOLVED, INVESTOR, INVENTORY, INVESTORS, INVOLVING, INVESTING, INVESTMENT, INVESTMENTS, INVOLVEMENT, INVESTIGATION
UND - UNDER, UNDERWEAR, UNDEFINED, UNDERSTAND, UNDERSTOOD, UNDERLYING, UNDERTAKEN, UNDERGROUND, UNDERSTANDING, UNDERGRADUATE
