ABOV - ABOVE
THEI - THEIR
ITEM - ITEMS
TODA - TODAY
SINC - SINCE
BEFO - BEFORE
BETW - BETWEEN
SEPT - SEPTEMBER
SALE - SALES, SALEM
GIVE - GIVEN, GIVES
RATE - RATES, RATED
MIGH - MIGHT, MIGHTY
BOAR - BOARD, BOARDS
WOME - WOMEN, WOMENS
TOPI - TOPIC, TOPICS
HOTE - HOTEL, HOTELS
HOUR - HOURS, HOURLY
YOUN - YOUNG, YOUNGER
POKE - POKER, POKEMON
GERM - GERMAN, GERMANY
BECA - BECAME, BECAUSE
NUMB - NUMBER, NUMBERS
CRED - CREDIT, CREDITS
STAF - STAFF, STAFFING
RENT - RENTAL, RENTALS
DECE - DECENT, DECEMBER
SHOU - SHOULD, SHOULDER
GIRL - GIRLS, GIRLFRIEND
GALL - GALLERY, GALLERIES
SOFT - SOFTWARE, SOFTBALL
SOLU - SOLUTION, SOLUTIONS
NEVE - NEVER, NEVERTHELESS
UNIT - UNITS, UNITY, UNITED
MOVI - MOVIE, MOVIES, MOVING
DAVI - DAVID, DAVIS, DAVIDSON
BELO - BELOW, BELONG, BELONGS
OTHE - OTHER, OTHERS, OTHERWISE
THES - THESE, THESIS, THESAURUS
WHER - WHERE, WHEREAS, WHEREVER
PURP - PURPLE, PURPOSE, PURPOSES
SOUN - SOUND, SOUNDS, SOUNDTRACK
GARD - GARDEN, GARDENS, GARDENING
FAMI - FAMILY, FAMILIES, FAMILIAR
MULT - MULTI, MULTIPLE, MULTIMEDIA
WITH - WITHIN, WITHOUT, WITHDRAWAL
METH - METHOD, METHODS, METHODOLOGY
HIST - HISTORY, HISTORIC, HISTORICAL
TIME - TIMES, TIMER, TIMELY, TIMELINE
BEAU - BEAUTY, BEAUTIFUL, BEAUTIFULLY
TABL - TABLE, TABLES, TABLET, TABLETS
PRIC - PRICE, PRICES, PRICED, PRICING
STYL - STYLE, STYLES, STYLUS, STYLISH
FACT - FACTS, FACTOR, FACTORS, FACTORY
OWNE - OWNER, OWNED, OWNERS, OWNERSHIP
AUDI - AUDIO, AUDIT, AUDITOR, AUDIENCE
VERS - VERSE, VERSUS, VERSION, VERSIONS
NOTE - NOTES, NOTED, NOTEBOOK, NOTEBOOKS
LEAR - LEARN, LEARNED, LEARNING, LEARNERS
UPDA - UPDATE, UPDATED, UPDATES, UPDATING
EVEN - EVENT, EVENTS, EVENING, EVENTUALLY
STOC - STOCK, STOCKS, STOCKINGS, STOCKHOLM
PLEA - PLEASE, PLEASED, PLEASURE, PLEASANT
BLAC - BLACK, BLACKS, BLACKJACK, BLACKBERRY
WATE - WATER, WATERS, WATERSHED, WATERPROOF
RETU - RETURN, RETURNS, RETURNED, RETURNING
ANSW - ANSWER, ANSWERS, ANSWERED, ANSWERING
ORIG - ORIGIN, ORIGINS, ORIGINAL, ORIGINALLY
FRIE - FRIEND, FRIENDS, FRIENDLY, FRIENDSHIP
FEAT - FEATURE, FEATURES, FEATURED, FEATURING
AUST - AUSTIN, AUSTRIA, AUSTRALIA, AUSTRALIAN
OBJE - OBJECT, OBJECTS, OBJECTIVE, OBJECTIVES
BASI - BASIC, BASIS, BASIN, BASICS, BASICALLY
ECON - ECONOMY, ECONOMIC, ECONOMICS, ECONOMIES
PRIV - PRIVACY, PRIVATE, PRIVILEGE, PRIVILEGES
MESS - MESSAGE, MESSAGES, MESSENGER, MESSAGING
CHEA - CHEAP, CHEAT, CHEATS, CHEAPER, CHEAPEST
BRAN - BRAND, BRANDS, BRANCH, BRANDON, BRANCHES
POIN - POINT, POINTS, POINTER, POINTED, POINTING
CAME - CAMEL, CAMERA, CAMERAS, CAMERON, CAMEROON
RADI - RADIO, RADIUS, RADIOS, RADICAL, RADIATION
SPON - SPONSOR, SPONSORS, SPONSORED, SPONSORSHIP
CARE - CAREY, CAREER, CAREERS, CAREFUL, CAREFULLY
LOGI - LOGIN, LOGIC, LOGICAL, LOGITECH, LOGISTICS
ANIM - ANIME, ANIMAL, ANIMALS, ANIMATED, ANIMATION
COPY - COPYING, COPYRIGHT, COPYRIGHTS, COPYRIGHTED
LEAD - LEADS, LEADER, LEADING, LEADERS, LEADERSHIP
GROU - GROUP, GROUPS, GROUND, GROUNDS, GROUNDWATER
TEAC - TEACH, TEACHER, TEACHES, TEACHING, TEACHERS
FLOR - FLORAL, FLORIDA, FLORIST, FLORISTS, FLORENCE
POPU - POPULAR, POPULATION, POPULARITY, POPULATIONS
SIMP - SIMPLE, SIMPLY, SIMPSON, SIMPSONS, SIMPLIFIED
UNIV - UNIVERSE, UNIVERSAL, UNIVERSITY, UNIVERSITIES
LICE - LICENSE, LICENCE, LICENSED, LICENSES, LICENSING
PROB - PROBE, PROBLEM, PROBLEMS, PROBABLY, PROBABILITY
RELE - RELEASE, RELEASES, RELEASED, RELEVANT, RELEVANCE
HUMA - HUMAN, HUMANS, HUMANITY, HUMANITIES, HUMANITARIAN
SPEA - SPEAK, SPEARS, SPEAKS, SPEAKER, SPEAKERS, SPEAKING
CORP - CORPS, CORPUS, CORPORATE, CORPORATION, CORPORATIONS
SCIE - SCIENCE, SCIENCES, SCIENTIST, SCIENTIFIC, SCIENTISTS
BELI - BELIEF, BELIZE, BELIEVE, BELIEFS, BELIEVED, BELIEVES
HOME - HOMES, HOMEPAGE, HOMEWORK, HOMELAND, HOMELESS, HOMETOWN
HARD - HARDER, HARDLY, HARDWARE, HARDCORE, HARDWOOD, HARDCOVER
ARTI - ARTIST, ARTICLE, ARTISTS, ARTICLES, ARTISTIC, ARTIFICIAL
READ - READY, READS, READER, READING, READERS, READILY, READINGS
NATI - NATION, NATIVE, NATIONS, NATIONAL, NATIONWIDE, NATIONALLY
TEST - TESTS, TESTED, TESTING, TESTIMONY, TESTAMENT, TESTIMONIALS
WRIT - WRITE, WRITER, WRITES, WRITTEN, WRITING, WRITERS, WRITINGS
COUR - COURT, COURSE, COURTS, COURSES, COURIER, COURAGE, COURTESY
DOCU - DOCUMENT, DOCUMENTS, DOCUMENTED, DOCUMENTARY, DOCUMENTATION
FUNC - FUNCTION, FUNCTIONS, FUNCTIONAL, FUNCTIONING, FUNCTIONALITY
MONT - MONTH, MONTE, MONTHS, MONTHLY, MONTANA, MONTREAL, MONTGOMERY
EVER - EVERY, EVERYONE, EVERYDAY, EVERYBODY, EVERYTHING, EVERYWHERE
SCHO - SCHOOL, SCHOOLS, SCHOLAR, SCHOLARS, SCHOLARSHIP, SCHOLARSHIPS
SELE - SELECT, SELECTED, SELECTION, SELECTING, SELECTIVE, SELECTIONS
OFFE - OFFER, OFFERS, OFFERED, OFFENSE, OFFERING, OFFENSIVE, OFFERINGS
JOUR - JOURNAL, JOURNEY, JOURNALS, JOURNALISM, JOURNALIST, JOURNALISTS
FORE - FOREST, FOREIGN, FOREVER, FORESTS, FORECAST, FORESTRY, FORECASTS
CLOS - CLOSE, CLOSED, CLOSER, CLOSES, CLOSING, CLOSELY, CLOSURE, CLOSEST
MEAS - MEASURE, MEASURES, MEASURED, MEASURING, MEASUREMENT, MEASUREMENTS
FRAN - FRANK, FRANCE, FRANCIS, FRANKLIN, FRANCISCO, FRANCHISE, FRANKFURT
FAVO - FAVOR, FAVORS, FAVOUR, FAVORITE, FAVORITES, FAVOURITE, FAVOURITES
LIGH - LIGHT, LIGHTS, LIGHTER, LIGHTING, LIGHTBOX, LIGHTNING, LIGHTWEIGHT
SCHE - SCHEME, SCHEMA, SCHEMES, SCHEDULE, SCHEDULED, SCHEDULES, SCHEDULING
INFO - INFORM, INFORMED, INFORMAL, INFORMATION, INFORMATIVE, INFORMATIONAL
INCR - INCREASE, INCREASED, INCREASES, INCREASING, INCREDIBLE, INCREASINGLY
STUD - STUDY, STUDIO, STUDENT, STUDIES, STUDIOS, STUDIED, STUDENTS, STUDYING
EXTR - EXTRA, EXTRAS, EXTREME, EXTRACT, EXTREMELY, EXTRACTION, EXTRAORDINARY
CERT - CERTAIN, CERTIFIED, CERTAINLY, CERTIFICATE, CERTIFICATES, CERTIFICATION
RELI - RELIEF, RELIGION, RELIABLE, RELIANCE, RELIGIOUS, RELIGIONS, RELIABILITY
PREV - PREVENT, PREVIEW, PREVIOUS, PREVIEWS, PREVENTION, PREVIOUSLY, PREVENTING
GREE - GREEN, GREEK, GREECE, GREENE, GREETING, GREETINGS, GREENSBORO, GREENHOUSE
PERM - PERMIT, PERMITS, PERMANENT, PERMALINK, PERMITTED, PERMISSION, PERMISSIONS
ALLO - ALLOW, ALLOY, ALLOWS, ALLOWED, ALLOWING, ALLOCATED, ALLOWANCE, ALLOCATION
ANAL - ANALOG, ANALYST, ANALYZE, ANALYSIS, ANALYSES, ANALYSTS, ANALYZED, ANALYTICAL
PACK - PACKS, PACKET, PACKED, PACKAGE, PACKARD, PACKING, PACKETS, PACKAGES, PACKAGING
SOME - SOMEONE, SOMEHOW, SOMEWHAT, SOMEBODY, SOMERSET, SOMETHING, SOMETIMES, SOMEWHERE
NOTI - NOTICE, NOTIFY, NOTION, NOTICES, NOTICED, NOTIFIED, NOTIFICATION, NOTIFICATIONS
PLAN - PLANS, PLANT, PLANE, PLANTS, PLANET, PLANES, PLANNED, PLANNER, PLANETS, PLANNING
RESO - RESORT, RESORTS, RESOLVE, RESOURCE, RESOLVED, RESOURCES, RESOLUTION, RESOLUTIONS
VISI - VISIT, VISION, VISITS, VISITOR, VISIBLE, VISITED, VISITORS, VISITING, VISIBILITY
DEFI - DEFINE, DEFINED, DEFINES, DEFICIT, DEFINING, DEFINITION, DEFINITELY, DEFINITIONS
PLAY - PLAYS, PLAYER, PLAYED, PLAYERS, PLAYING, PLAYBOY, PLAYLIST, PLAYBACK, PLAYSTATION
QUAL - QUALITY, QUALIFY, QUALIFIED, QUALITIES, QUALIFYING, QUALIFICATION, QUALIFICATIONS
STRA - STRAP, STRAIN, STRAND, STRANGE, STRATEGY, STRAIGHT, STRANGER, STRATEGIC, STRATEGIES
OPTI - OPTION, OPTICS, OPTIONS, OPTICAL, OPTIMAL, OPTIMUM, OPTIONAL, OPTIMIZE, OPTIMIZATION
STRI - STRIP, STRING, STRIKE, STRICT, STRIPS, STRINGS, STRIKES, STRIPES, STRICTLY, STRIKING
COLO - COLOR, COLON, COLOUR, COLORS, COLONY, COLORED, COLOURS, COLORADO, COLOMBIA, COLONIAL
TRAI - TRAIN, TRAIL, TRAILS, TRAINS, TRAILER, TRAINED, TRAINER, TRAINING, TRAILERS, TRAINERS
TRAC - TRACK, TRACE, TRACY, TRACT, TRACKS, TRACKED, TRACKER, TRACKING, TRACKBACK, TRACKBACKS
HAND - HANDS, HANDY, HANDLE, HANDED, HANDJOB, HANDLED, HANDLES, HANDLING, HANDBOOK, HANDHELD
TRAV - TRAVEL, TRAVIS, TRAVELS, TRAVELER, TRAVESTI, TRAVELING, TRAVELERS, TRAVELLER, TRAVELLING
REPL - REPLY, REPLIES, REPLACE, REPLICA, REPLIED, REPLACED, REPLACING, REPLACEMENT, REPLICATION
BREA - BREAK, BREAD, BREAST, BREAKS, BREATH, BREASTS, BREAKING, BREAKFAST, BREAKDOWN, BREATHING
ASSE - ASSET, ASSETS, ASSESS, ASSEMBLY, ASSESSED, ASSESSING, ASSEMBLED, ASSESSMENT, ASSESSMENTS
POST - POSTS, POSTED, POSTER, POSTAL, POSTERS, POSTING, POSTAGE, POSTINGS, POSTCARDS, POSTPOSTED
MODE - MODEL, MODEM, MODES, MODELS, MODERN, MODELING, MODERATE, MODERATOR, MODELLING, MODERATORS
TRAD - TRADE, TRADES, TRADER, TRADING, TRADEMARK, TRADITION, TRADEMARKS, TRADITIONS, TRADITIONAL
IMPO - IMPORT, IMPOSE, IMPORTS, IMPOSED, IMPORTED, IMPORTANT, IMPORTANCE, IMPOSSIBLE, IMPORTANTLY
REGI - REGION, REGIME, REGIONS, REGISTER, REGIONAL, REGISTRY, REGISTRAR, REGISTERED, REGISTRATION
REFE - REFER, REFERS, REFERRED, REFERRAL, REFERENCE, REFERRING, REFERRALS, REFERENCES, REFERENCED
COUN - COUNT, COUNTY, COUNTS, COUNTRY, COUNCIL, COUNTER, COUNSEL, COUNTIES, COUNTRIES, COUNSELING
INTR - INTRO, INTRANET, INTRODUCE, INTRODUCED, INTRODUCES, INTRODUCING, INTRODUCTION, INTRODUCTORY
AUTO - AUTOS, AUTOMATIC, AUTOMATED, AUTOMOTIVE, AUTOMATION, AUTOMOBILE, AUTOMOBILES, AUTOMATICALLY
STRE - STREET, STREAM, STRESS, STREETS, STRETCH, STREAMS, STRENGTH, STREAMING, STRENGTHS, STRENGTHEN
MAIN - MAINE, MAINLY, MAINTAIN, MAINLAND, MAINTAINS, MAINTAINED, MAINSTREAM, MAINTENANCE, MAINTAINING
IDEN - IDENTIFY, IDENTITY, IDENTICAL, IDENTIFIED, IDENTIFIER, IDENTIFIES, IDENTIFYING, IDENTIFICATION
COND - CONDO, CONDOS, CONDUCT, CONDITION, CONDUCTED, CONDITIONS, CONDUCTING, CONDITIONAL, CONDITIONING
WORK - WORKS, WORKED, WORKER, WORKING, WORKERS, WORKSHOP, WORKSHOPS, WORKPLACE, WORKFORCE, WORKSTATION
MEDI - MEDIA, MEDIUM, MEDIAN, MEDICAL, MEDICINE, MEDICARE, MEDIEVAL, MEDICAID, MEDICATION, MEDICATIONS
HIGH - HIGHS, HIGHER, HIGHLY, HIGHEST, HIGHWAY, HIGHLAND, HIGHWAYS, HIGHLIGHT, HIGHLIGHTS, HIGHLIGHTED
HEAD - HEADS, HEADER, HEADED, HEADSET, HEADING, HEADERS, HEADLINE, HEADLINES, HEADPHONES, HEADQUARTERS
RECE - RECENT, RECEIVE, RECEIPT, RECEIVED, RECENTLY, RECEIVER, RECEIVES, RECEPTOR, RECEIVING, RECEPTION
THRE - THREE, THREAD, THREAT, THREADS, THREATS, THREADED, THRESHOLD, THREESOME, THREATENED, THREATENING
PROM - PROMO, PROMPT, PROMOTE, PROMISE, PROMISED, PROMISES, PROMOTION, PROMOTING, PROMOTIONS, PROMOTIONAL
EXTE - EXTENT, EXTEND, EXTENDS, EXTERNAL, EXTENDED, EXTERIOR, EXTENSION, EXTENSIVE, EXTENDING, EXTENSIONS
CHAR - CHART, CHARGE, CHARTS, CHARLES, CHARGES, CHARGED, CHARACTER, CHARLOTTE, CHARACTERS, CHARACTERISTICS
DESI - DESIGN, DESIRE, DESIGNS, DESIRED, DESIGNED, DESIGNER, DESIGNERS, DESIGNING, DESIGNATED, DESIGNATION
PROP - PROPER, PROPOSE, PROPERTY, PROPOSED, PROPOSAL, PROPERLY, PROPOSALS, PROPERTIES, PROPORTION, PROPRIETARY
RELA - RELAY, RELAX, RELATED, RELATIVE, RELATING, RELATION, RELATIONS, RELATIVELY, RELATIONSHIP, RELATIONSHIPS
PHOT - PHOTO, PHOTOS, PHOTOSHOP, PHOTOGRAPH, PHOTOGRAPHY, PHOTOGRAPHS, PHOTOGRAPHER, PHOTOGRAPHIC, PHOTOGRAPHERS
DIRE - DIRECT, DIRECTOR, DIRECTLY, DIRECTED, DIRECTORY, DIRECTION, DIRECTORS, DIRECTIVE, DIRECTIONS, DIRECTORIES
EXPL - EXPLORE, EXPLAIN, EXPLORER, EXPLAINS, EXPLICIT, EXPLAINED, EXPLORING, EXPLICITLY, EXPLANATION, EXPLORATION
EXPE - EXPERT, EXPECT, EXPERTS, EXPECTED, EXPENSES, EXPENSIVE, EXPERIENCE, EXPERIENCED, EXPERIENCES, EXPERIMENTAL
RESE - RESET, RESERVE, RESEARCH, RESERVED, RESERVES, RESELLER, RESEARCHER, RESERVATION, RESEARCHERS, RESERVATIONS
REQU - REQUEST, REQUIRE, REQUIRED, REQUIRES, REQUESTS, REQUESTED, REQUIRING, REQUESTING, REQUIREMENT, REQUIREMENTS
SPEC - SPECS, SPECIAL, SPECIES, SPECIFIC, SPECIALS, SPECIFIED, SPECIALTY, SPECIALIST, SPECIFICALLY, SPECIFICATIONS
TECH - TECHNO, TECHNICAL, TECHNIQUE, TECHNOLOGY, TECHNIQUES, TECHNICIAN, TECHNOLOGIES, TECHREPUBLIC, TECHNOLOGICAL
PART - PARTY, PARTS, PARTNER, PARTIES, PARTNERS, PARTICULAR, PARTNERSHIP, PARTICULARLY, PARTICIPANTS, PARTICIPATION
DISC - DISCUSS, DISCOUNT, DISCOVER, DISCUSSED, DISCOVERY, DISCOUNTS, DISCUSSION, DISCLAIMER, DISCOVERED, DISCUSSIONS
CORR - CORRECT, CORRECTLY, CORRECTED, CORRECTION, CORRUPTION, CORRECTIONS, CORRELATION, CORRESPONDING, CORRESPONDENCE
DETE - DETECT, DETECTED, DETECTOR, DETERMINE, DETECTION, DETECTIVE, DETERMINED, DETERMINES, DETERMINING, DETERMINATION
COMM - COMMON, COMMENT, COMMAND, COMMENTS, COMMUNITY, COMMITTEE, COMMERCIAL, COMMISSION, COMMUNICATION, COMMUNICATIONS
DEVE - DEVEL, DEVELOP, DEVELOPS, DEVELOPED, DEVELOPER, DEVELOPING, DEVELOPERS, DEVELOPMENT, DEVELOPMENTS, DEVELOPMENTAL
INST - INSTEAD, INSTALL, INSTANT, INSTANCE, INSTITUTE, INSTALLED, INSTRUMENTS, INSTRUCTIONS, INSTALLATION, INSTITUTIONS
CONF - CONFIG, CONFIRM, CONFLICT, CONFIRMED, CONFIGURE, CONFERENCE, CONFIDENCE, CONFERENCES, CONFIRMATION, CONFIGURATION
COLL - COLLEGE, COLLECT, COLLINS, COLLEGES, COLLECTED, COLLECTION, COLLECTIONS, COLLECTIBLES, COLLECTABLES, COLLABORATION
CONS - CONSUMER, CONSIDER, CONSTANT, CONSUMERS, CONSIDERED, CONSULTING, CONSISTENT, CONSTITUTES, CONSTRUCTION, CONSERVATION
UNDE - UNDER, UNDERWEAR, UNDEFINED, UNDERSTAND, UNDERSTOOD, UNDERLYING, UNDERTAKEN, UNDERGROUND, UNDERSTANDING, UNDERGRADUATE
CONV - CONVERT, CONVERTER, CONVERTED, CONVENTION, CONVERSION, CONVENIENT, CONVENIENCE, CONVENTIONS, CONVERSATION, CONVENTIONAL
RESP - RESPECT, RESPOND, RESPONSE, RESPONSES, RESPECTIVE, RESPONSIBLE, RESPONDENTS, RESPECTIVELY, RESPONSIBILITY, RESPONSIBILITIES
