TION - INFORMATION, EDUCATION, SECTION, LOCATION, DESCRIPTION, ACTION, APPLICATION, QUESTION, EDITION, ASSOCIATION
MENT - MANAGEMENT, DEVELOPMENT, GOVERNMENT, DEPARTMENT, COMMENT, PAYMENT, EQUIPMENT, ENTERTAINMENT, AGREEMENT, ENVIRONMENT
IONS - CONDITIONS, QUESTIONS, OPTIONS, SOLUTIONS, APPLICATIONS, COMMUNICATIONS, OPERATIONS, PUBLICATIONS, LOCATIONS, RELATIONS
TING - RATING, LISTING, MEETING, MARKETING, HOSTING, GETTING, WRITING, STARTING, OPERATING, EXISTING
COMP - COMPANY, COMPUTER, COMPARE, COMPLETE, COMPANIES, COMPUTERS, COMPONENTS, COMPLETED, COMPLEX, COMPONENT
CONT - CONTACT, CONTROL, CONTENT, CONTENTS, CONTINUE, CONTRACT, CONTAINS, CONTEXT, CONTINUED, CONTACTS
THER - OTHER, THERE, ANOTHER, FURTHER, WHETHER, WEATHER, EITHER, TOGETHER, RATHER, THEREFORE, OTHER, THERE, ANOTHER, FURTHER, WHETHER, WEATHER, EITHER, TOGETHER, RATHER, THEREFORE, MOTHER, FATHER, LEATHER, THERAPY, BROTHER, NEITHER, THERMAL, THEREOF, HEATHER, THERAPEUTIC, THEREBY, GATHER, LUTHER, THERAPIST, THEREAFTER, BOTHER
ENTS - COMMENTS, STUDENTS, EVENTS, REQUIREMENTS, CONTENTS, DOCUMENTS, PARENTS, PATIENTS, COMPONENTS, AGENTS
COMM - COMMENTS, COMMUNITY, COMMENT, COMMITTEE, COMMON, COMMERCIAL, COMMISSION, COMMUNICATIONS, COMMUNICATION, COMMAND
INTE - INTERNATIONAL, INTERNET, INTEREST, INTERFACE, INTERNAL, INTERESTED, INTERESTING, INTERESTS, INTEGRATED, INTENDED
ONAL - INTERNATIONAL, NATIONAL, PERSONAL, ADDITIONAL, PROFESSIONAL, REGIONAL, EDUCATIONAL, TRADITIONAL, FUNCTIONAL, OPTIONAL
ARCH - SEARCH, RESEARCH, MARCH, ARCHIVE, ARCHIVES, ARCHITECTURE, CITYSEARCH, ARCHIVED, ARCHITECTURAL, ARCHITECT
DING - INCLUDING, BUILDING, READING, ACCORDING, WEDDING, PROVIDING, LEADING, REGARDING, UNDERSTANDING, FUNDING
IGHT - COPYRIGHT, RIGHT, NIGHT, LIGHT, MIGHT, WEIGHT, FLIGHT, EIGHT, STRAIGHT, FIGHT
SERV - SERVICES, SERVICE, SERVER, SERVERS, SERVE, SERVED, SERVING, SERVES
ANCE - INSURANCE, PERFORMANCE, FRANCE, FINANCE, DISTANCE, ASSISTANCE, MAINTENANCE, DANCE, ADVANCE, CHANCE
STAT - STATE, STATES, STATUS, STATEMENT, STATISTICS, STATION, STATEMENTS, STATED, STATS, STATIC
MBER - NUMBER, MEMBER, DECEMBER, NOVEMBER, SEPTEMBER, REMEMBER, CHAMBER, AMBER, TIMBER
SION - VERSION, DISCUSSION, COMMISSION, DECISION, DIVISION, SESSION, MISSION, TELEVISION, VISION, PERMISSION
OULD - WOULD, SHOULD, COULD
ABOU - ABOUT
BOUT - ABOUT, BOUTIQUE
NING - TRAINING, LEARNING, PLANNING, RUNNING, WARNING, MORNING, BEGINNING, OPENING, EVENING, WINNING
ATED - RELATED, UPDATED, CREATED, LOCATED, ASSOCIATED, RATED, GENERATED, DESIGNATED, INTEGRATED, DEDICATED
HERE - THERE, WHERE, ANYWHERE, ELSEWHERE, ATMOSPHERE, SOMEWHERE, HEREIN, EVERYWHERE, HEREBY, NOWHERE
OTHE - OTHER, OTHERS, OTHERWISE
KING - LOOKING, WORKING, MAKING, KINGDOM, TAKING, FUCKING, NETWORKING, THINKING, TALKING, PARKING
ABLE - AVAILABLE, TABLE, CABLE, ENABLE, VARIABLE, PORTABLE, APPLICABLE, REASONABLE, PRINTABLE, AFFORDABLE
SEAR - SEARCH, SEARCHES, SEARCHING, SEARCHED
ENCE - SCIENCE, EXPERIENCE, REFERENCE, CONFERENCE, EVIDENCE, DIFFERENCE, SEQUENCE, INTELLIGENCE, VIOLENCE, PRESENCE
PROD - PRODUCTS, PRODUCT, PRODUCTION, PRODUCED, PRODUCE, PRODUCTIONS, PRODUCER, PRODUCTIVITY, PRODUCING, PRODUCERS
TURE - PICTURE, FUTURE, NATURE, MATURE, CULTURE, FURNITURE, STRUCTURE, FEATURE, LITERATURE, TEMPERATURE
RIES - CATEGORIES, SERIES, ACCESSORIES, STORIES, COUNTRIES, GALLERIES, ENTRIES, INDUSTRIES, LIBRARIES, BATTERIES
ICAL - MEDICAL, TECHNICAL, POLITICAL, PHYSICAL, CRITICAL, MUSICAL, CLINICAL, HISTORICAL, CHEMICAL, ELECTRICAL
RING - DURING, ENGINEERING, SPRING, BRING, STRING, RINGTONES, MONITORING, MANUFACTURING, HEARING, OFFERING
TIVE - ACTIVE, EFFECTIVE, EXECUTIVE, POSITIVE, ALTERNATIVE, CREATIVE, RESPECTIVE, AUTOMOTIVE, ADMINISTRATIVE, INTERACTIVE
INFO - INFORMATION, INFORMED, INFORM, INFORMATIONAL, INFORMAL, INFORMATIVE
ICES - SERVICES, PRICES, DEVICES, PRACTICES, OFFICES, CHOICES, NOTICES, VOICES, INDICES
PORT - SUPPORT, REPORT, AIRPORT, SPORT, TRANSPORT, PORTABLE, PORTAL, PORTFOLIO, IMPORT, EXPORT
ALLY - REALLY, USUALLY, ACTUALLY, ESPECIALLY, FINALLY, GENERALLY, AUTOMATICALLY, ORIGINALLY, SPECIFICALLY, TOTALLY
CONS - CONSTRUCTION, CONSUMER, CONSIDERED, CONSIDER, CONSULTING, CONSTITUTES, CONSERVATION, CONSTANT, CONSISTENT, CONSUMERS
HING - SOMETHING, THING, EVERYTHING, ANYTHING, NOTHING, CLOTHING, TEACHING, PUBLISHING, FISHING, MATCHING
SING - USING, SINGLE, ADVERTISING, HOUSING, PROCESSING, NURSING, MISSING, SINGLES, INCREASING, SINGAPORE
LITY - QUALITY, AVAILABILITY, RESPONSIBILITY, ABILITY, FACILITY, REALITY, UTILITY, LIABILITY, DISABILITY, ACCESSIBILITY
CIAL - SPECIAL, FINANCIAL, SOCIAL, OFFICIAL, COMMERCIAL, INTERRACIAL, CIALIS, FACIAL, JUDICIAL, ARTIFICIAL
TIES - ACTIVITIES, FACILITIES, OPPORTUNITIES, PROPERTIES, CITIES, PARTIES, COMMUNITIES, UTILITIES, AUTHORITIES, SECURITIES
WHIC - WHICH
HICH - WHICH
INGS - THINGS, LISTINGS, RATINGS, SETTINGS, MEETINGS, SAVINGS, SPRINGS, RINGS, BUILDINGS, PROCEEDINGS
STOR - STORE, STORES, STORY, STORIES, STORAGE, INVESTOR, STORM, STORED, PASTOR
NESS - BUSINESS, FITNESS, AWARENESS, EFFECTIVENESS, WITNESS, ILLNESS, WELLNESS, DARKNESS, HAPPINESS, CONSCIOUSNESS
PRIC - PRICE, PRICES, PRICING, PRICED
ATES - STATES, RATES, ASSOCIATES, UPDATES, DATES, AFFILIATES, ESTIMATES, CERTIFICATES, INDICATES, CANDIDATES
THEI - THEIR
HEIR - THEIR
COUN - COUNTY, COUNTRY, COUNCIL, COUNTRIES, COUNT, COUNTER, COUNTIES, COUNTS, COUNSEL, COUNSELING
LINE - ONLINE, LINES, LINEAR, OFFLINE, AIRLINE, MEDLINE, PIPELINE, DEADLINE, OUTLINE, DISCIPLINE
SUPP - SUPPORT, SUPPLIES, SUPPLY, SUPPORTED, SUPPLIED, SUPPORTS, SUPPLIERS, SUPPORTING, SUPPLIER, SUPPOSED
OUND - FOUND, AROUND, SOUND, ROUND, GROUND, BACKGROUND, BOUND, UNDERGROUND, POUND, COMPOUND
TORY - HISTORY, DIRECTORY, STORY, LABORATORY, FACTORY, INVENTORY, REGULATORY, TERRITORY, VICTORY, STATUTORY
REVI - REVIEW, REVIEWS, REVIEWED, REVISED, REVISION, REVIEWER, REVIEWING, REVISIONS
PART - PARTY, PARTS, PARTICULAR, PARTNERS, PARTNER, PARTIES, PARTICULARLY, PARTNERSHIP, PARTICIPANTS, PARTICIPATION
PROV - PROVIDE, PROVIDED, PROVIDES, PROVIDING, PROVIDER, PROVIDERS, PROVISIONS, PROVISION, PROVINCE, PROVE
SPEC - SPECIAL, SPECIFIC, SPECIFIED, SPECIES, SPECIFICATIONS, SPECIALS, SPECIFICALLY, SPECS, SPECIALIST, SPECIALTY
RESE - RESEARCH, RESERVED, RESERVE, RESERVATIONS, RESERVATION, RESEARCHERS, RESERVES, RESET, RESELLER, RESEARCHER
PUBL - PUBLIC, PUBLISHED, PUBLICATIONS, PUBLISHER, PUBLICATION, PUBLISHING, PUBLISHERS, PUBLISH, PUBLICLY, PUBLICITY
STUD - STUDENTS, STUDY, STUDENT, STUDIES, STUDIO, STUDIOS, STUDIED, STUDYING
POLI - POLICY, POLICIES, POLITICAL, POLICE, POLITICS, POLISH, POLITICIANS, POLISHED
PRES - PRESS, PRESIDENT, PRESENT, PRESSURE, PRESENTED, PRESENTATION, PRESENCE, PRESCRIPTION, PRESENTS, PRESENTATIONS
BUSI - BUSINESS, BUSINESSES
EASE - PLEASE, RELEASE, INCREASE, DISEASE, LEASE, DECREASE
RESS - ADDRESS, PRESS, EXPRESS, PROGRESS, CONGRESS, DRESS, STRESS, WORDPRESS, MISTRESS, ACTRESS
POST - POSTED, POSTS, POSTER, POSTERS, POSTAL, POSTING, POSTAGE, POSTPOSTED, POSTINGS, POSTCARDS
NTER - CENTER, ENTER, PRINTER, WINTER, COUNTER, HUNTER, MILFHUNTER, INTER, POINTER, PICHUNTER
PROG - PROGRAM, PROGRAMS, PROGRAMME, PROGRAMMING, PROGRESS, PROGRAMMES, PROGRESSIVE, PROGRAMMER, PROGRAMMERS
LOCA - LOCAL, LOCATION, LOCATED, LOCATIONS, LOCATE, LOCATOR, LOCALLY, LOCALE
TATE - STATE, ESTATE, FACILITATE, INTERSTATE, PROSTATE
TACT - CONTACT, TACTICS
VICE - SERVICE, ADVICE, DEVICE
DIRE - DIRECTORY, DIRECTOR, DIRECT, DIRECTLY, DIRECTIONS, DIRECTION, DIRECTORS, DIRECTED, DIRECTORIES, DIRECTIVE
PING - SHIPPING, SHOPPING, DEVELOPING, KEEPING, HELPING, MAPPING, CAMPING, SLEEPING, HOPING, WRAPPING
OUGH - THROUGH, THOUGH, ENOUGH, ALTHOUGH, TOUGH, ROUGH, OUGHT, BOROUGH, THOROUGH
CENT - CENTER, RECENT, CENTRAL, CENTRE, PERCENT, CENTURY, CENTERS, CENTRES, VINCENT, CENTS
AGES - PAGES, IMAGES, MESSAGES, PACKAGES, LANGUAGES, MORTGAGES, DAMAGES, STAGES, ADVANTAGES, WAGES
URES - PICTURES, FEATURES, PROCEDURES, MEASURES, FIGURES, STRUCTURES, ADVENTURES, CULTURES, EXPENDITURES, LECTURES
TERS - COMPUTERS, LETTERS, CHARACTERS, CENTERS, POSTERS, NEWSLETTERS, PARAMETERS, MATTERS, PRINTERS, WRITERS
SYST - SYSTEM, SYSTEMS, SYSTEMATIC
RIGH - RIGHTS, RIGHT
INCL - INCLUDING, INCLUDE, INCLUDES, INCLUDED, INCLUSIVE, INCLUSION
ACCE - ACCESS, ACCESSORIES, ACCEPTED, ACCEPT, ACCEPTANCE, ACCESSIBILITY, ACCESSIBLE, ACCESSORY, ACCEPTABLE, ACCESSED
INST - AGAINST, INSTITUTE, INSTEAD, INSTRUCTIONS, INSTRUMENTS, INSTALLATION, INSTALL, INSTITUTIONS, INSTALLED, INSTANT
STED - POSTED, LISTED, INTERESTED, SUGGESTED, REQUESTED, HOSTED, TESTED, POSTPOSTED, TRUSTED, ADJUSTED
ONLI - ONLINE
LING - MAILING, SELLING, HANDLING, LINGERIE, CALLING, GAMBLING, FEELING, STERLING, WILLING, DEALING
GENE - GENERAL, GENERALLY, GENERATION, GENERATED, GENERIC, GENERATE, GENETIC, GENERATOR, GENES, GENETICS
REQU - REQUIRED, REQUEST, REQUIREMENTS, REQUIRE, REQUIRES, REQUESTS, REQUESTED, REQUIREMENT, REQUIRING, REQUESTING
FIRS - FIRST
IRST - FIRST
MEDI - MEDIA, MEDICAL, MEDICINE, MEDIUM, MEDICATION, MEDIAN, MEDICARE, MEDICATIONS, MEDIEVAL, MEDICAID
