TION - INFORMATION, EDUCATION, SECTION, LOCATION, DESCRIPTION, ACTION, APPLICATION, QUESTION, EDITION, ASSOCIATION
MENT - MANAGEMENT, DEVELOPMENT, GOVERNMENT, DEPARTMENT, COMMENT, PAYMENT, EQUIPMENT, ENTERTAINMENT, AGREEMENT, ENVIRONMENT
IONS - CONDITIONS, QUESTIONS, OPTIONS, SOLUTIONS, APPLICATIONS, COMMUNICATIONS, OPERATIONS, PUBLICATIONS, LOCATIONS, RELATIONS
TING - RATING, LISTING, MEETING, MARKETING, HOSTING, GETTING, WRITING, STARTING, OPERATING, EXISTING
THER - OTHER, ANOTHER, FURTHER, WHETHER, WEATHER, EITHER, TOGETHER, RATHER, MOTHER, FATHER
ENTS - COMMENTS, STUDENTS, EVENTS, REQUIREMENTS, CONTENTS, DOCUMENTS, PARENTS, PATIENTS, COMPONENTS, AGENTS
ONAL - INTERNATIONAL, NATIONAL, PERSONAL, ADDITIONAL, PROFESSIONAL, REGIONAL, EDUCATIONAL, TRADITIONAL, FUNCTIONAL, OPTIONAL
ARCH - SEARCH, RESEARCH, MARCH, CITYSEARCH
DING - INCLUDING, BUILDING, READING, ACCORDING, WEDDING, PROVIDING, LEADING, REGARDING, UNDERSTANDING, FUNDING
IGHT - COPYRIGHT, RIGHT, NIGHT, LIGHT, MIGHT, WEIGHT, FLIGHT, EIGHT, STRAIGHT, FIGHT
ANCE - INSURANCE, PERFORMANCE, FRANCE, FINANCE, DISTANCE, ASSISTANCE, MAINTENANCE, DANCE, ADVANCE, CHANCE
MBER - NUMBER, MEMBER, DECEMBER, NOVEMBER, SEPTEMBER, REMEMBER, CHAMBER, AMBER, TIMBER
SION - VERSION, DISCUSSION, COMMISSION, DECISION, DIVISION, SESSION, MISSION, TELEVISION, VISION, PERMISSION
OULD - WOULD, SHOULD, COULD
BOUT - ABOUT
NING - TRAINING, LEARNING, PLANNING, RUNNING, WARNING, MORNING, BEGINNING, OPENING, EVENING, WINNING
ATED - RELATED, UPDATED, CREATED, LOCATED, ASSOCIATED, RATED, GENERATED, DESIGNATED, INTEGRATED, DEDICATED
HERE - THERE, WHERE, ANYWHERE, ELSEWHERE, ATMOSPHERE, SOMEWHERE, EVERYWHERE, NOWHERE, SPHERE
KING - LOOKING, WORKING, MAKING, TAKING, FUCKING, NETWORKING, THINKING, TALKING, PARKING, BANKING
ABLE - AVAILABLE, TABLE, CABLE, ENABLE, VARIABLE, PORTABLE, APPLICABLE, REASONABLE, PRINTABLE, AFFORDABLE
ENCE - SCIENCE, EXPERIENCE, REFERENCE, CONFERENCE, EVIDENCE, DIFFERENCE, SEQUENCE, INTELLIGENCE, VIOLENCE, PRESENCE
TURE - PICTURE, FUTURE, NATURE, MATURE, CULTURE, FURNITURE, STRUCTURE, FEATURE, LITERATURE, TEMPERATURE
RIES - CATEGORIES, SERIES, ACCESSORIES, STORIES, COUNTRIES, GALLERIES, ENTRIES, INDUSTRIES, LIBRARIES, BATTERIES
ICAL - MEDICAL, TECHNICAL, POLITICAL, PHYSICAL, CRITICAL, MUSICAL, CLINICAL, HISTORICAL, CHEMICAL, ELECTRICAL
RING - DURING, ENGINEERING, SPRING, BRING, STRING, MONITORING, MANUFACTURING, HEARING, OFFERING, SHARING
TIVE - ACTIVE, EFFECTIVE, EXECUTIVE, POSITIVE, ALTERNATIVE, CREATIVE, RESPECTIVE, AUTOMOTIVE, ADMINISTRATIVE, INTERACTIVE
ICES - SERVICES, PRICES, DEVICES, PRACTICES, OFFICES, CHOICES, NOTICES, VOICES, INDICES
PORT - SUPPORT, REPORT, AIRPORT, SPORT, TRANSPORT, IMPORT, EXPORT, NEWPORT, PASSPORT
ALLY - REALLY, USUALLY, ACTUALLY, ESPECIALLY, FINALLY, GENERALLY, AUTOMATICALLY, ORIGINALLY, SPECIFICALLY, TOTALLY
HING - SOMETHING, THING, EVERYTHING, ANYTHING, NOTHING, CLOTHING, TEACHING, PUBLISHING, FISHING, MATCHING
SING - USING, ADVERTISING, HOUSING, PROCESSING, NURSING, MISSING, INCREASING, LICENSING, CLOSING, PURCHASING
LITY - QUALITY, AVAILABILITY, RESPONSIBILITY, ABILITY, FACILITY, REALITY, UTILITY, LIABILITY, DISABILITY, ACCESSIBILITY
CIAL - SPECIAL, FINANCIAL, SOCIAL, OFFICIAL, COMMERCIAL, INTERRACIAL, FACIAL, JUDICIAL, ARTIFICIAL, CRUCIAL
TIES - ACTIVITIES, FACILITIES, OPPORTUNITIES, PROPERTIES, CITIES, PARTIES, COMMUNITIES, UTILITIES, AUTHORITIES, SECURITIES
HICH - WHICH
INGS - THINGS, LISTINGS, RATINGS, SETTINGS, MEETINGS, SAVINGS, SPRINGS, RINGS, BUILDINGS, PROCEEDINGS
NESS - BUSINESS, FITNESS, AWARENESS, EFFECTIVENESS, WITNESS, ILLNESS, WELLNESS, DARKNESS, HAPPINESS, CONSCIOUSNESS
ATES - STATES, RATES, ASSOCIATES, UPDATES, DATES, AFFILIATES, ESTIMATES, CERTIFICATES, INDICATES, CANDIDATES
HEIR - THEIR
LINE - ONLINE, OFFLINE, AIRLINE, MEDLINE, PIPELINE, DEADLINE, OUTLINE, DISCIPLINE, DECLINE, BASELINE
OUND - FOUND, AROUND, SOUND, ROUND, GROUND, BACKGROUND, BOUND, UNDERGROUND, POUND, COMPOUND
TORY - HISTORY, DIRECTORY, STORY, LABORATORY, FACTORY, INVENTORY, REGULATORY, TERRITORY, VICTORY, STATUTORY
EASE - PLEASE, RELEASE, INCREASE, DISEASE, LEASE, DECREASE
RESS - ADDRESS, PRESS, EXPRESS, PROGRESS, CONGRESS, DRESS, STRESS, WORDPRESS, MISTRESS, ACTRESS
NTER - CENTER, ENTER, PRINTER, WINTER, COUNTER, HUNTER, MILFHUNTER, INTER, POINTER, PICHUNTER
TATE - STATE, ESTATE, FACILITATE, INTERSTATE, PROSTATE
TACT - CONTACT
VICE - SERVICE, ADVICE, DEVICE
PING - SHIPPING, SHOPPING, DEVELOPING, KEEPING, HELPING, MAPPING, CAMPING, SLEEPING, HOPING, WRAPPING
OUGH - THROUGH, THOUGH, ENOUGH, ALTHOUGH, TOUGH, ROUGH, BOROUGH, THOROUGH
AGES - PAGES, IMAGES, MESSAGES, PACKAGES, LANGUAGES, MORTGAGES, DAMAGES, STAGES, ADVANTAGES, WAGES
URES - PICTURES, FEATURES, PROCEDURES, MEASURES, FIGURES, STRUCTURES, ADVENTURES, CULTURES, EXPENDITURES, LECTURES
TERS - COMPUTERS, LETTERS, CHARACTERS, CENTERS, POSTERS, NEWSLETTERS, PARAMETERS, MATTERS, PRINTERS, WRITERS
STED - POSTED, LISTED, INTERESTED, SUGGESTED, REQUESTED, HOSTED, TESTED, POSTPOSTED, TRUSTED, ADJUSTED
LING - MAILING, SELLING, HANDLING, CALLING, GAMBLING, FEELING, STERLING, WILLING, DEALING, FILING
IRST - FIRST
JECT - SUBJECT, PROJECT, OBJECT, REJECT
STER - REGISTER, MASTER, MINISTER, POSTER, FASTER, WEBMASTER, SISTER, MANCHESTER, MONSTER, DISASTER
ERAL - GENERAL, SEVERAL, FEDERAL, LIBERAL, FUNERAL, MINERAL, PERIPHERAL
LAND - ISLAND, ENGLAND, IRELAND, ZEALAND, MARYLAND, SCOTLAND, THAILAND, PORTLAND, SWITZERLAND, CLEVELAND
WARE - SOFTWARE, HARDWARE, AWARE, SPYWARE, DELAWARE, SHAREWARE, FREEWARE, FIRMWARE, ADWARE
TEMS - ITEMS, SYSTEMS
VING - HAVING, LIVING, MOVING, GIVING, DRIVING, SERVING, RECEIVING, LEAVING, SAVING, IMPROVING
HESE - THESE
ITED - UNITED, LIMITED, UNLIMITED, EDITED, PROHIBITED, VISITED, INVITED, CITED, EXCITED, ACCREDITED
LICK - CLICK
GHTS - RIGHTS, THOUGHTS, FLIGHTS, LIGHTS, NIGHTS, HIGHLIGHTS, HEIGHTS, COPYRIGHTS, INSIGHTS, WEIGHTS
ERED - POWERED, REGISTERED, CONSIDERED, OFFERED, COVERED, DELIVERED, ENTERED, ORDERED, DISCOVERED, ANSWERED
RICE - PRICE, LISTPRICE
ORTS - SPORTS, REPORTS, EFFORTS, SUPPORTS, RESORTS, PORTS, SHORTS, IMPORTS, EXPORTS, AIRPORTS
AMES - GAMES, JAMES, NAMES, FRAMES
CESS - ACCESS, PROCESS, SUCCESS, EXCESS, PRINCESS
NDER - UNDER, GENDER, WONDER, FINDER, ALEXANDER, FOUNDER, COMMANDER, SENDER, TENDER, REMINDER
OPLE - PEOPLE
ANGE - CHANGE, RANGE, EXCHANGE, ORANGE, STRANGE, ARRANGE
ALTH - HEALTH, WEALTH, COMMONWEALTH
RENT - CURRENT, DIFFERENT, PARENT, APPARENT, TRANSPARENT
VIEW - REVIEW, OVERVIEW, INTERVIEW, PREVIEW
OUNT - ACCOUNT, AMOUNT, DISCOUNT, COUNT, MOUNT
MAIL - EMAIL, HOTMAIL
OOKS - BOOKS, LOOKS, TEXTBOOKS, NOTEBOOKS, BROOKS, EBOOKS
UARY - JANUARY, FEBRUARY
RITY - SECURITY, AUTHORITY, PRIORITY, MAJORITY, CELEBRITY, POPULARITY, CHARITY, MINORITY, INTEGRITY, CLARITY
SAGE - MESSAGE, USAGE, MASSAGE, PASSAGE, DOSAGE
ORLD - WORLD
DUCT - PRODUCT, CONDUCT
ARDS - CARDS, STANDARDS, BOARDS, AWARDS, TOWARDS, YARDS, REGARDS, EDWARDS, KEYBOARDS, REWARDS
TTER - BETTER, NEWSLETTER, LETTER, MATTER, POTTER, LATTER, BUTTER
WING - FOLLOWING, SHOWING, GROWING, VIEWING, DRAWING, ALLOWING, KNOWING, SWING, REVIEWING, SEWING
IOUS - PREVIOUS, VARIOUS, SERIOUS, RELIGIOUS, OBVIOUS, PRECIOUS, CURIOUS, DELICIOUS, INFECTIOUS, CONSCIOUS
RDER - ORDER, BORDER, MURDER, CAMCORDER, RECORDER, DISORDER, HARDER
DENT - STUDENT, PRESIDENT, INDEPENDENT, DEPENDENT, ACCIDENT, RESIDENT, INCIDENT, RESPONDENT, CONFIDENT, EVIDENT
EARS - YEARS, APPEARS, BEARS, SPEARS, TEARS, FEARS
IEWS - REVIEWS, VIEWS, INTERVIEWS, PREVIEWS
UCTS - PRODUCTS
USIC - MUSIC
BLIC - PUBLIC, REPUBLIC, TECHREPUBLIC
IBLE - POSSIBLE, RESPONSIBLE, BIBLE, ELIGIBLE, COMPATIBLE, FLEXIBLE, ACCESSIBLE, VISIBLE, IMPOSSIBLE, INCREDIBLE
TORS - VISITORS, FACTORS, DIRECTORS, EDITORS, CONTRACTORS, OPERATORS, DOCTORS, MONITORS, INVESTORS, INDICATORS
STEM - SYSTEM
