COMP - COMPANY, COMPUTER, COMPARE, COMPLETE, COMPANIES, COMPUTERS, COMPONENTS, COMPLETED, COMPLEX, COMPONENT
CONT - CONTACT, CONTROL, CONTENT, CONTENTS, CONTINUE, CONTRACT, CONTAINS, CONTEXT, CONTINUED, CONTACTS
COMM - COMMENTS, COMMUNITY, COMMENT, COMMITTEE, COMMON, COMMERCIAL, COMMISSION, COMMUNICATIONS, COMMUNICATION, COMMAND
INTE - INTERNATIONAL, INTERNET, INTEREST, INTERFACE, INTERNAL, INTERESTED, INTERESTING, INTERESTS, INTEGRATED, INTENDED
SERV - SERVICES, SERVICE, SERVER, SERVERS, SERVE, SERVED, SERVING, SERVES
STAT - STATE, STATES, STATUS, STATEMENT, STATISTICS, STATION, STATEMENTS, STATED, STATS, STATIC
ABOU - ABOUT
OTHE - OTHER, OTHERS, OTHERWISE
SEAR - SEARCH, SEARCHES, SEARCHING, SEARCHED
PROD - PRODUCTS, PRODUCT, PRODUCTION, PRODUCED, PRODUCE, PRODUCTIONS, PRODUCER, PRODUCTIVITY, PRODUCING, PRODUCERS
INFO - INFORMATION, INFORMED, INFORM, INFORMATIONAL, INFORMAL, INFORMATIVE
CONS - CONSTRUCTION, CONSUMER, CONSIDERED, CONSIDER, CONSULTING, CONSTITUTES, CONSERVATION, CONSTANT, CONSISTENT, CONSUMERS
THER - THERE, THEREFORE, THERAPY, THERMAL, THEREOF, THERAPEUTIC, THEREBY, THERAPIST, THEREAFTER
WHIC - WHICH
STOR - STORE, STORES, STORY, STORIES, STORAGE, STORM, STORED
PRIC - PRICE, PRICES, PRICING, PRICED
THEI - THEIR
COUN - COUNTY, COUNTRY, COUNCIL, COUNTRIES, COUNT, COUNTER, COUNTIES, COUNTS, COUNSEL, COUNSELING
SUPP - SUPPORT, SUPPLIES, SUPPLY, SUPPORTED, SUPPLIED, SUPPORTS, SUPPLIERS, SUPPORTING, SUPPLIER, SUPPOSED
REVI - REVIEW, REVIEWS, REVIEWED, REVISED, REVISION, REVIEWER, REVIEWING, REVISIONS
PART - PARTY, PARTS, PARTICULAR, PARTNERS, PARTNER, PARTIES, PARTICULARLY, PARTNERSHIP, PARTICIPANTS, PARTICIPATION
PROV - PROVIDE, PROVIDED, PROVIDES, PROVIDING, PROVIDER, PROVIDERS, PROVISIONS, PROVISION, PROVINCE, PROVE
SPEC - SPECIAL, SPECIFIC, SPECIFIED, SPECIES, SPECIFICATIONS, SPECIALS, SPECIFICALLY, SPECS, SPECIALIST, SPECIALTY
RESE - RESEARCH, RESERVED, RESERVE, RESERVATIONS, RESERVATION, RESEARCHERS, RESERVES, RESET, RESELLER, RESEARCHER
PUBL - PUBLIC, PUBLISHED, PUBLICATIONS, PUBLISHER, PUBLICATION, PUBLISHING, PUBLISHERS, PUBLISH, PUBLICLY, PUBLICITY
STUD - STUDENTS, STUDY, STUDENT, STUDIES, STUDIO, STUDIOS, STUDIED, STUDYING
POLI - POLICY, POLICIES, POLITICAL, POLICE, POLITICS, POLISH, POLITICIANS, POLISHED
PRES - PRESS, PRESIDENT, PRESENT, PRESSURE, PRESENTED, PRESENTATION, PRESENCE, PRESCRIPTION, PRESENTS, PRESENTATIONS
BUSI - BUSINESS, BUSINESSES
POST - POSTED, POSTS, POSTER, POSTERS, POSTAL, POSTING, POSTAGE, POSTPOSTED, POSTINGS, POSTCARDS
PROG - PROGRAM, PROGRAMS, PROGRAMME, PROGRAMMING, PROGRESS, PROGRAMMES, PROGRESSIVE, PROGRAMMER, PROGRAMMERS
LOCA - LOCAL, LOCATION, LOCATED, LOCATIONS, LOCATE, LOCATOR, LOCALLY, LOCALE
DIRE - DIRECTORY, DIRECTOR, DIRECT, DIRECTLY, DIRECTIONS, DIRECTION, DIRECTORS, DIRECTED, DIRECTORIES, DIRECTIVE
CENT - CENTER, CENTRAL, CENTRE, CENTURY, CENTERS, CENTRES, CENTS, CENTURIES, CENTERED
SYST - SYSTEM, SYSTEMS, SYSTEMATIC
RIGH - RIGHTS, RIGHT
INCL - INCLUDING, INCLUDE, INCLUDES, INCLUDED, INCLUSIVE, INCLUSION
ACCE - ACCESS, ACCESSORIES, ACCEPTED, ACCEPT, ACCEPTANCE, ACCESSIBILITY, ACCESSIBLE, ACCESSORY, ACCEPTABLE, ACCESSED
INST - INSTITUTE, INSTEAD, INSTRUCTIONS, INSTRUMENTS, INSTALLATION, INSTALL, INSTITUTIONS, INSTALLED, INSTANT, INSTANCE
ONLI - ONLINE
GENE - GENERAL, GENERALLY, GENERATION, GENERATED, GENERIC, GENERATE, GENETIC, GENERATOR, GENES, GENETICS
REQU - REQUIRED, REQUEST, REQUIREMENTS, REQUIRE, REQUIRES, REQUESTS, REQUESTED, REQUIREMENT, REQUIRING, REQUESTING
FIRS - FIRST
MEDI - MEDIA, MEDICAL, MEDICINE, MEDIUM, MEDICATION, MEDIAN, MEDICARE, MEDICATIONS, MEDIEVAL, MEDICAID
HOTE - HOTEL, HOTELS
WOUL - WOULD
MEMB - MEMBER, MEMBERS, MEMBERSHIP, MEMBRANE
CHAN - CHANGE, CHANGES, CHANNEL, CHANGED, CHANCE, CHANGING, CHANNELS, CHANCES, CHANGELOG, CHANCELLOR
REGI - REGISTER, REGION, REGISTERED, REGIONAL, REGISTRATION, REGIONS, REGISTRY, REGIME, REGISTRAR
RECO - RECORD, RECORDS, RECOMMENDED, RECOMMEND, RECOVERY, RECOMMENDATIONS, RECORDING, RECORDED, RECOGNITION, RECOGNIZED
DEVE - DEVELOPMENT, DEVELOPED, DEVELOP, DEVELOPING, DEVELOPER, DEVEL, DEVELOPERS, DEVELOPMENTS, DEVELOPMENTAL, DEVELOPS
DISC - DISCUSSION, DISCOUNT, DISCLAIMER, DISCUSS, DISCUSSIONS, DISCOVER, DISCUSSED, DISCOVERY, DISCOUNTS, DISCOVERED
CLIC - CLICK, CLICKING, CLICKS
THES - THESE, THESIS, THESAURUS
APPL - APPLICATION, APPLICATIONS, APPLY, APPLE, APPLIED, APPLICABLE, APPLIANCES, APPLICANT, APPLIES, APPLYING
ACTI - ACTION, ACTIVITIES, ACTIVE, ACTIVITY, ACTIONS, ACTING, ACTIVATION, ACTIVELY, ACTIVATED, ACTIVISTS
PERS - PERSONAL, PERSON, PERSONS, PERSONNEL, PERSONALS, PERSPECTIVE, PERSONALLY, PERSONALIZED, PERSONALITY, PERSPECTIVES
COLL - COLLEGE, COLLECTION, COLLECTIBLES, COLLECTIONS, COLLEGES, COLLECTED, COLLABORATION, COLLECTABLES, COLLECT, COLLINS
PRIV - PRIVACY, PRIVATE, PRIVILEGE, PRIVILEGES
GROU - GROUP, GROUPS, GROUND, GROUNDS, GROUNDWATER
DESI - DESIGN, DESIGNED, DESIGNATED, DESIGNS, DESIGNER, DESIRE, DESIGNERS, DESIRED, DESIGNING, DESIGNATION
LIST - LISTING, LISTED, LISTINGS, LISTS, LISTEN, LISTENING, LISTPRICE
REPO - REPORT, REPORTS, REPORTED, REPORTING, REPORTER, REPOSITORY, REPORTERS
PHOT - PHOTO, PHOTOS, PHOTOGRAPHY, PHOTOGRAPHS, PHOTOGRAPHER, PHOTOGRAPH, PHOTOSHOP, PHOTOGRAPHIC, PHOTOGRAPHERS
THIN - THINK, THINGS, THING, THINKING, THINKS, THINKPAD
WORL - WORLD, WORLDWIDE, WORLDS, WORLDSEX, WORLDCAT
EXPE - EXPERIENCE, EXPECTED, EXPERT, EXPECT, EXPERTS, EXPERIENCED, EXPENSES, EXPERIENCES, EXPERIMENTAL, EXPENSIVE
PRIN - PRINT, PRINTER, PRINTING, PRINCIPLES, PRINCIPAL, PRINTED, PRINTERS, PRINTS, PRINCE, PRINTABLE
OFFI - OFFICE, OFFICIAL, OFFICER, OFFICES, OFFICIALS, OFFICERS, OFFICIALLY
MESS - MESSAGE, MESSAGES, MESSENGER, MESSAGING
HEAL - HEALTH, HEALTHY, HEALTHCARE, HEALING
UNDE - UNDER, UNDERSTAND, UNDERSTANDING, UNDERGROUND, UNDERGRADUATE, UNDERSTOOD, UNDERLYING, UNDERWEAR, UNDEFINED, UNDERTAKEN
ACCO - ACCOUNT, ACCORDING, ACCOMMODATION, ACCOUNTS, ACCOUNTING, ACCORDANCE, ACCOMMODATIONS, ACCOUNTABILITY, ACCORDINGLY, ACCOMPANIED
MANA - MANAGEMENT, MANAGER, MANAGE, MANAGED, MANAGING, MANAGERS
RELA - RELATED, RELATIONS, RELATIONSHIP, RELATIONSHIPS, RELATIVE, RELATING, RELATION, RELATIVELY, RELAY, RELAX
SCHO - SCHOOL, SCHOOLS, SCHOLARSHIP, SCHOLARSHIPS, SCHOLARS, SCHOLAR
TECH - TECHNOLOGY, TECHNICAL, TECHNOLOGIES, TECHNIQUES, TECHNIQUE, TECHNOLOGICAL, TECHNO, TECHNICIAN, TECHREPUBLIC
PEOP - PEOPLE, PEOPLES
WITH - WITHIN, WITHOUT, WITHDRAWAL
TRAN - TRANSFER, TRANSPORTATION, TRANSPORT, TRANSLATION, TRANSIT, TRANSMISSION, TRANSACTIONS, TRANSACTION, TRANSITION, TRANS
PROF - PROFILE, PROFESSIONAL, PROFESSOR, PROFIT, PROFESSIONALS, PROFILES, PROFITS, PROFESSION
RECE - RECENT, RECEIVED, RECEIVE, RECENTLY, RECEIVING, RECEIVER, RECEIPT, RECEPTION, RECEIVES, RECEPTOR
THRE - THREE, THREAD, THREADS, THREAT, THRESHOLD, THREATS, THREADED, THREESOME, THREATENED, THREATENING
INDI - INDIVIDUAL, INDIA, INDIAN, INDIVIDUALS, INDIANA, INDICATE, INDICATED, INDICATES, INDICATORS, INDIANAPOLIS
CHAR - CHARGE, CHARACTER, CHARLES, CHARACTERS, CHARGES, CHART, CHARTS, CHARACTERISTICS, CHARGED, CHARLOTTE
MUSI - MUSIC, MUSICAL, MUSICIANS, MUSICIAN
ARTI - ARTICLE, ARTICLES, ARTIST, ARTISTS, ARTIFICIAL, ARTISTIC
RESO - RESOURCES, RESOURCE, RESOLUTION, RESORT, RESORTS, RESOLVED, RESOLVE, RESOLUTIONS
ORDE - ORDER, ORDERS, ORDERING, ORDERED
PROC - PROCESS, PROCESSING, PROCEDURES, PROCESSES, PROCEDURE, PROCEEDINGS, PROCESSOR, PROCESSED, PROCEED, PROCESSORS
AVAI - AVAILABLE, AVAILABILITY
VIDE - VIDEO, VIDEOS
EMAI - EMAIL, EMAILS
RESU - RESULTS, RESULT, RESULTING, RESUME, RESULTED, RESUMES
CLAS - CLASS, CLASSIC, CLASSES, CLASSIFIEDS, CLASSICAL, CLASSIFIED, CLASSROOM, CLASSIFICATION, CLASSICS
NUMB - NUMBER, NUMBERS
PROP - PROPERTY, PROPERTIES, PROPOSED, PROPOSAL, PROPER, PROPERLY, PROPOSALS, PROPORTION, PROPRIETARY, PROPOSE
WORK - WORKING, WORKS, WORKERS, WORKED, WORKSHOP, WORKSHOPS, WORKER, WORKPLACE, WORKFORCE, WORKSTATION
THRO - THROUGH, THROUGHOUT, THROW, THROAT, THROWS, THROWN, THROWING
FINA - FINANCIAL, FINAL, FINANCE, FINALLY, FINANCING, FINANCES, FINALS
