COMP - COMPANY, COMPUTER, COMPARE, COMPLETE, COMPANIES, COMPUTERS, COMPONENTS, COMPLETED, COMPLEX, COMPONENT
CONT - CONTACT, CONTROL, CONTENT, CONTENTS, CONTINUE, CONTRACT, CONTAINS, CONTEXT, CONTINUED, CONTACTS
COMM - COMMENTS, COMMUNITY, COMMENT, COMMITTEE, COMMON, COMMERCIAL, COMMISSION, COMMUNICATIONS, COMMUNICATION, COMMAND
INTE - INTERNATIONAL, INTERNET, INTEREST, INTERFACE, INTERNAL, INTERESTED, INTERESTING, INTERESTS, INTEGRATED, INTENDED
STAT - STATE, STATES, STATUS, STATEMENT, STATISTICS, STATION, STATEMENTS, STATED, STATS, STATIC
PROD - PRODUCTS, PRODUCT, PRODUCTION, PRODUCED, PRODUCE, PRODUCTIONS, PRODUCER, PRODUCTIVITY, PRODUCING, PRODUCERS
CONS - CONSTRUCTION, CONSUMER, CONSIDERED, CONSIDER, CONSULTING, CONSTITUTES, CONSERVATION, CONSTANT, CONSISTENT, CONSUMERS
COUN - COUNTY, COUNTRY, COUNCIL, COUNTRIES, COUNT, COUNTER, COUNTIES, COUNTS, COUNSEL, COUNSELING
SUPP - SUPPORT, SUPPLIES, SUPPLY, SUPPORTED, SUPPLIED, SUPPORTS, SUPPLIERS, SUPPORTING, SUPPLIER, SUPPOSED
PART - PARTY, PARTS, PARTICULAR, PARTNERS, PARTNER, PARTIES, PARTICULARLY, PARTNERSHIP, PARTICIPANTS, PARTICIPATION
PROV - PROVIDE, PROVIDED, PROVIDES, PROVIDING, PROVIDER, PROVIDERS, PROVISIONS, PROVISION, PROVINCE, PROVE
SPEC - SPECIAL, SPECIFIC, SPECIFIED, SPECIES, SPECIFICATIONS, SPECIALS, SPECIFICALLY, SPECS, SPECIALIST, SPECIALTY
RESE - RESEARCH, RESERVED, RESERVE, RESERVATIONS, RESERVATION, RESEARCHERS, RESERVES, RESET, RESELLER, RESEARCHER
PUBL - PUBLIC, PUBLISHED, PUBLICATIONS, PUBLISHER, PUBLICATION, PUBLISHING, PUBLISHERS, PUBLISH, PUBLICLY, PUBLICITY
PRES - PRESS, PRESIDENT, PRESENT, PRESSURE, PRESENTED, PRESENTATION, PRESENCE, PRESCRIPTION, PRESENTS, PRESENTATIONS
POST - POSTED, POSTS, POSTER, POSTERS, POSTAL, POSTING, POSTAGE, POSTPOSTED, POSTINGS, POSTCARDS
DIRE - DIRECTORY, DIRECTOR, DIRECT, DIRECTLY, DIRECTIONS, DIRECTION, DIRECTORS, DIRECTED, DIRECTORIES, DIRECTIVE
ACCE - ACCESS, ACCESSORIES, ACCEPTED, ACCEPT, ACCEPTANCE, ACCESSIBILITY, ACCESSIBLE, ACCESSORY, ACCEPTABLE, ACCESSED
INST - INSTITUTE, INSTEAD, INSTRUCTIONS, INSTRUMENTS, INSTALLATION, INSTALL, INSTITUTIONS, INSTALLED, INSTANT, INSTANCE
GENE - GENERAL, GENERALLY, GENERATION, GENERATED, GENERIC, GENERATE, GENETIC, GENERATOR, GENES, GENETICS
REQU - REQUIRED, REQUEST, REQUIREMENTS, REQUIRE, REQUIRES, REQUESTS, REQUESTED, REQUIREMENT, REQUIRING, REQUESTING
MEDI - MEDIA, MEDICAL, MEDICINE, MEDIUM, MEDICATION, MEDIAN, MEDICARE, MEDICATIONS, MEDIEVAL, MEDICAID
CHAN - CHANGE, CHANGES, CHANNEL, CHANGED, CHANCE, CHANGING, CHANNELS, CHANCES, CHANGELOG, CHANCELLOR
RECO - RECORD, RECORDS, RECOMMENDED, RECOMMEND, RECOVERY, RECOMMENDATIONS, RECORDING, RECORDED, RECOGNITION, RECOGNIZED
DEVE - DEVELOPMENT, DEVELOPED, DEVELOP, DEVELOPING, DEVELOPER, DEVEL, DEVELOPERS, DEVELOPMENTS, DEVELOPMENTAL, DEVELOPS
DISC - DISCUSSION, DISCOUNT, DISCLAIMER, DISCUSS, DISCUSSIONS, DISCOVER, DISCUSSED, DISCOVERY, DISCOUNTS, DISCOVERED
APPL - APPLICATION, APPLICATIONS, APPLY, APPLE, APPLIED, APPLICABLE, APPLIANCES, APPLICANT, APPLIES, APPLYING
ACTI - ACTION, ACTIVITIES, ACTIVE, ACTIVITY, ACTIONS, ACTING, ACTIVATION, ACTIVELY, ACTIVATED, ACTIVISTS
PERS - PERSONAL, PERSON, PERSONS, PERSONNEL, PERSONALS, PERSPECTIVE, PERSONALLY, PERSONALIZED, PERSONALITY, PERSPECTIVES
COLL - COLLEGE, COLLECTION, COLLECTIBLES, COLLECTIONS, COLLEGES, COLLECTED, COLLABORATION, COLLECTABLES, COLLECT, COLLINS
DESI - DESIGN, DESIGNED, DESIGNATED, DESIGNS, DESIGNER, DESIRE, DESIGNERS, DESIRED, DESIGNING, DESIGNATION
EXPE - EXPERIENCE, EXPECTED, EXPERT, EXPECT, EXPERTS, EXPERIENCED, EXPENSES, EXPERIENCES, EXPERIMENTAL, EXPENSIVE
PRIN - PRINT, PRINTER, PRINTING, PRINCIPLES, PRINCIPAL, PRINTED, PRINTERS, PRINTS, PRINCE, PRINTABLE
UNDE - UNDER, UNDERSTAND, UNDERSTANDING, UNDERGROUND, UNDERGRADUATE, UNDERSTOOD, UNDERLYING, UNDERWEAR, UNDEFINED, UNDERTAKEN
ACCO - ACCOUNT, ACCORDING, ACCOMMODATION, ACCOUNTS, ACCOUNTING, ACCORDANCE, ACCOMMODATIONS, ACCOUNTABILITY, ACCORDINGLY, ACCOMPANIED
RELA - RELATED, RELATIONS, RELATIONSHIP, RELATIONSHIPS, RELATIVE, RELATING, RELATION, RELATIVELY, RELAY, RELAX
TRAN - TRANSFER, TRANSPORTATION, TRANSPORT, TRANSLATION, TRANSIT, TRANSMISSION, TRANSACTIONS, TRANSACTION, TRANSITION, TRANS
RECE - RECENT, RECEIVED, RECEIVE, RECENTLY, RECEIVING, RECEIVER, RECEIPT, RECEPTION, RECEIVES, RECEPTOR
THRE - THREE, THREAD, THREADS, THREAT, THRESHOLD, THREATS, THREADED, THREESOME, THREATENED, THREATENING
INDI - INDIVIDUAL, INDIA, INDIAN, INDIVIDUALS, INDIANA, INDICATE, INDICATED, INDICATES, INDICATORS, INDIANAPOLIS
CHAR - CHARGE, CHARACTER, CHARLES, CHARACTERS, CHARGES, CHART, CHARTS, CHARACTERISTICS, CHARGED, CHARLOTTE
PROC - PROCESS, PROCESSING, PROCEDURES, PROCESSES, PROCEDURE, PROCEEDINGS, PROCESSOR, PROCESSED, PROCEED, PROCESSORS
PROP - PROPERTY, PROPERTIES, PROPOSED, PROPOSAL, PROPER, PROPERLY, PROPOSALS, PROPORTION, PROPRIETARY, PROPOSE
WORK - WORKING, WORKS, WORKERS, WORKED, WORKSHOP, WORKSHOPS, WORKER, WORKPLACE, WORKFORCE, WORKSTATION
RESP - RESPONSE, RESPONSIBLE, RESPONSIBILITY, RESPECT, RESPECTIVE, RESPONSES, RESPOND, RESPECTIVELY, RESPONSIBILITIES, RESPONDENTS
CREA - CREATE, CREATED, CREATIVE, CREATING, CREATION, CREAM, CREATES, CREATOR, CREATIVITY, CREATURES
MODE - MODEL, MODELS, MODERN, MODERATOR, MODEM, MODELING, MODES, MODERATE, MODERATORS, MODELLING
ELEC - ELECTRONICS, ELECTRONIC, ELECTRIC, ELECTION, ELECTRICAL, ELECTIONS, ELECTED, ELECTRICITY, ELECTRON, ELECTRO
PLAN - PLANNING, PLANS, PLANT, PLANTS, PLANET, PLANNED, PLANE, PLANNER, PLANETS, PLANES
CONF - CONFERENCE, CONFIGURATION, CONFLICT, CONFIDENCE, CONFIRM, CONFERENCES, CONFIRMED, CONFIGURE, CONFIG, CONFIRMATION
DIST - DISTRICT, DISTRIBUTION, DISTANCE, DISTRIBUTED, DISTRICTS, DISTRIBUTOR, DISTINCT, DISTRIBUTE, DISTRIBUTORS, DISTINGUISHED
DIFF - DIFFERENT, DIFFERENCE, DIFFICULT, DIFFERENCES, DIFFICULTY, DIFFICULTIES, DIFFER, DIFFERENTIAL, DIFFERENTLY, DIFFS
FORM - FORMAT, FORMS, FORMER, FORMAL, FORMULA, FORMED, FORMATS, FORMATION, FORMERLY, FORMING
APPR - APPROPRIATE, APPROACH, APPROVED, APPROXIMATELY, APPROVAL, APPROACHES, APPRECIATE, APPROX, APPROVE, APPRECIATED
PERF - PERFORMANCE, PERFECT, PERFORM, PERFORMED, PERFORMING, PERFUME, PERFECTLY, PERFORMANCES, PERFORMS, PERFORMER
TRAI - TRAINING, TRAIN, TRAIL, TRAILER, TRAILERS, TRAINED, TRAILS, TRAINER, TRAINS, TRAINERS
STRE - STREET, STREAM, STRENGTH, STRESS, STREETS, STRETCH, STREAMING, STREAMS, STRENGTHEN, STRENGTHS
OPER - OPERATING, OPERATIONS, OPERATION, OPERATOR, OPERATORS, OPERATE, OPERA, OPERATIONAL, OPERATED, OPERATES
PROT - PROTECTION, PROTEIN, PROTECT, PROTOCOL, PROTECTED, PROTEINS, PROTECTIVE, PROTOCOLS, PROTECTING, PROTEST
ADVE - ADVERTISING, ADVERTISE, ADVENTURE, ADVERTISEMENT, ADVENTURES, ADVERTISERS, ADVERSE, ADVERTISER, ADVERTISEMENTS, ADVERT
CONC - CONCEPT, CONCERNS, CONCERNED, CONCERN, CONCERNING, CONCERT, CONCEPTS, CONCRETE, CONCLUSION, CONCENTRATION
SUBS - SUBSCRIBE, SUBSCRIPTION, SUBSCRIPTIONS, SUBSTANCE, SUBSTANCES, SUBSTANTIAL, SUBSECTION, SUBSEQUENT, SUBSCRIBER, SUBSCRIBERS
ORGA - ORGANIZATION, ORGANIZATIONS, ORGANIC, ORGANISATION, ORGANIZED, ORGANISATIONS, ORGANIZATIONAL, ORGAN, ORGANIZE, ORGANIZING
COLO - COLOR, COLORADO, COLOUR, COLORS, COLOMBIA, COLORED, COLOURS, COLONIAL, COLON, COLONY
PASS - PASSWORD, PASSED, PASSING, PASSION, PASSENGER, PASSES, PASSAGE, PASSPORT, PASSENGERS, PASSIVE
SIGN - SIGNIFICANT, SIGNED, SIGNAL, SIGNS, SIGNATURE, SIGNIFICANTLY, SIGNALS, SIGNIFICANCE, SIGNUP, SIGNING
CLEA - CLEAR, CLEAN, CLEARLY, CLEANING, CLEARANCE, CLEANER, CLEANERS, CLEARED, CLEARING, CLEANUP
ADMI - ADMINISTRATION, ADMINISTRATIVE, ADMIN, ADMINISTRATOR, ADMISSION, ADMISSIONS, ADMINISTRATORS, ADMITTED, ADMIT, ADMINISTERED
HIGH - HIGHER, HIGHEST, HIGHLY, HIGHWAY, HIGHLIGHTS, HIGHLIGHT, HIGHS, HIGHLAND, HIGHLIGHTED, HIGHWAYS
INVE - INVESTMENT, INVESTIGATION, INVESTOR, INVENTORY, INVESTMENTS, INVESTORS, INVESTING, INVESTIGATE, INVEST, INVESTIGATIONS
TRAC - TRACK, TRACKBACK, TRACKING, TRACKS, TRACKED, TRACE, TRACKER, TRACKBACKS, TRACY, TRACT
VARI - VARIOUS, VARIETY, VARIABLE, VARIABLES, VARIATION, VARIATIONS, VARIED, VARIES, VARIANCE, VARIETIES
BREA - BREAK, BREAST, BREAKFAST, BREAKING, BREASTS, BREAKS, BREAD, BREATH, BREAKDOWN, BREATHING
PORT - PORTABLE, PORTAL, PORTFOLIO, PORTION, PORTLAND, PORTS, PORTUGAL, PORTIONS, PORTUGUESE, PORTRAIT
EXCE - EXCELLENT, EXCEPT, EXCEPTION, EXCESS, EXCELLENCE, EXCEL, EXCEED, EXCERPT, EXCEPTIONAL, EXCEPTIONS
DISP - DISPLAY, DISPLAYED, DISPLAYS, DISPLAYING, DISPATCHED, DISPOSAL, DISPUTE, DISPATCH, DISPOSITION, DISPUTES
EXTE - EXTERNAL, EXTENDED, EXTENSION, EXTENT, EXTENSIVE, EXTEND, EXTENSIONS, EXTERIOR, EXTENDS, EXTENDING
HAND - HANDS, HANDLE, HANDLING, HANDBOOK, HANDHELD, HANDJOB, HANDED, HANDY, HANDLED, HANDLES
CONV - CONVENTION, CONVERSION, CONVERTER, CONVERTED, CONVERT, CONVERSATION, CONVENIENT, CONVENTIONAL, CONVENIENCE, CONVENTIONS
REPR - REPRESENTATIVE, REPRESENT, REPRESENTATIVES, REPRESENTS, REPRESENTATION, REPRESENTED, REPRODUCTION, REPRESENTING, REPRODUCED, REPRINTS
TREA - TREATMENT, TREATED, TREAT, TREATMENTS, TREASURY, TREATY, TREASURE, TREASURER, TREATING, TREASURES
REST - RESTAURANTS, RESTAURANT, RESTRICTIONS, RESTRICTED, RESTORATION, RESTORE, RESTRICTION, RESTORED, RESTRICT, RESTRUCTURING
PROM - PROMOTE, PROMOTION, PROMISE, PROMOTIONS, PROMOTIONAL, PROMOTING, PROMPT, PROMISED, PROMISES, PROMO
EXPL - EXPLORE, EXPLAIN, EXPLORER, EXPLAINED, EXPLANATION, EXPLAINS, EXPLORATION, EXPLICIT, EXPLORING, EXPLICITLY
DETE - DETERMINE, DETERMINED, DETECTION, DETERMINATION, DETERMINING, DETECTED, DETECT, DETECTOR, DETERMINES, DETECTIVE
STRI - STRING, STRIP, STRIKE, STRINGS, STRICTLY, STRICT, STRIKES, STRIKING, STRIPS, STRIPES
HEAD - HEADLINES, HEADER, HEADS, HEADQUARTERS, HEADSET, HEADING, HEADED, HEADERS, HEADPHONES, HEADLINE
TERR - TERRITORY, TERRORISM, TERRY, TERROR, TERRORIST, TERRITORIES, TERRIBLE, TERRACE, TERRORISTS, TERRAIN
MARI - MARINE, MARIA, MARIE, MARIO, MARINA, MARITIME, MARILYN, MARION, MARIJUANA, MARIAH
