THOS - THOSE
ERMS - TERMS
ORUM - FORUM
THEI - THEIR
NDEX - INDEX
ABOU - ABOUT
USIC - MUSIC
HOOL - SCHOOL
OPLE - PEOPLE
JANU - JANUARY
OTEL - HOTEL, MOTEL
BEIN - BEING, BEINGS
FORU - FORUM, FORUMS
HOTE - HOTEL, HOTELS
YEAR - YEARS, YEARLY
WOME - WOMEN, WOMENS
TEMS - ITEMS, SYSTEMS
AGAI - AGAIN, AGAINST
LICK - CLICK, LICKING
PEOP - PEOPLE, PEOPLES
ULTS - ADULTS, RESULTS
BECA - BECAME, BECAUSE
FICE - OFFICE, SACRIFICE
RNET - INTERNET, ETHERNET
ORTH - NORTH, WORTH, FORTH
OULD - WOULD, COULD, SHOULD
BUSI - BUSINESS, BUSINESSES
ISSU - ISSUE, ISSUES, ISSUED
TITL - TITLE, TITLES, TITLED
MOVI - MOVIE, MOVIES, MOVING
AUSE - CAUSE, CLAUSE, BECAUSE
TOTA - TOTAL, TOTALS, TOTALLY
SPOR - SPORT, SPORTS, SPORTING
CLIC - CLICK, CLICKS, CLICKING
AVAI - AVAILABLE, AVAILABILITY
CANA - CANAL, CANADA, CANADIAN
SMAL - SMALL, SMALLER, SMALLEST
GAME - GAMES, GAMECUBE, GAMESPOT
TORE - STORE, RESTORE, BOOKSTORE
DETA - DETAIL, DETAILS, DETAILED
RCES - FORCES, SOURCES, RESOURCES
WITH - WITHIN, WITHOUT, WITHDRAWAL
SUBJ - SUBJECT, SUBJECTS, SUBJECTIVE
HIST - HISTORY, HISTORIC, HISTORICAL
HOSE - THOSE, WHOSE, CHOSE, PANTYHOSE
GRAM - GRAMS, PROGRAM, DIAGRAM, GRAMMAR
IMES - TIMES, CRIMES, SOMETIMES, SHOWTIMES
MUSI - MUSIC, MUSICAL, MUSICIAN, MUSICIANS
IEWS - VIEWS, REVIEWS, PREVIEWS, INTERVIEWS
WATE - WATER, WATERS, WATERSHED, WATERPROOF
RETU - RETURN, RETURNS, RETURNED, RETURNING
SEAR - SEARCH, SEARCHES, SEARCHED, SEARCHING
ICLE - ARTICLE, VEHICLE, PARTICLE, CHRONICLE
ALTH - HEALTH, WEALTH, ALTHOUGH, COMMONWEALTH
TICE - NOTICE, JUSTICE, PRACTICE, MALPRACTICE
OURS - HOURS, TOURS, YOURS, COLOURS, OURSELVES
PRIV - PRIVACY, PRIVATE, PRIVILEGE, PRIVILEGES
LINK - LINKS, BLINK, LINKED, LINKING, PERMALINK
ADDR - ADDRESS, ADDRESSES, ADDRESSED, ADDRESSING
OUTH - SOUTH, YOUTH, MOUTH, PLYMOUTH, PORTSMOUTH
VALU - VALUE, VALUES, VALUED, VALUABLE, VALUATION
EARS - YEARS, BEARS, TEARS, FEARS, SPEARS, APPEARS
GUID - GUIDE, GUIDES, GUIDED, GUIDANCE, GUIDELINES
EDUC - EDUCATED, EDUCATION, EDUCATORS, EDUCATIONAL
CHIL - CHILD, CHILE, CHILDREN, CHILDHOOD, CHILDRENS
INAL - FINAL, ORIGINAL, CRIMINAL, TERMINAL, ABORIGINAL
TATE - STATE, ESTATE, PROSTATE, FACILITATE, INTERSTATE
RELE - RELEASE, RELEASES, RELEASED, RELEVANT, RELEVANCE
LOOK - LOOKS, LOOKED, LOOKUP, LOOKING, OUTLOOK, LOOKSMART
EASE - LEASE, PLEASE, RELEASE, DISEASE, INCREASE, DECREASE
ATER - WATER, LATER, HEATER, GREATER, THEATER, GROUNDWATER
SCIE - SCIENCE, SCIENCES, SCIENTIST, SCIENTIFIC, SCIENTISTS
TERM - TERMS, TERMINAL, TERMINALS, TERMINATION, TERMINOLOGY
RESU - RESULT, RESUME, RESULTS, RESUMES, RESULTED, RESULTING
CHEC - CHECK, CHECKS, CHECKED, CHECKOUT, CHECKING, CHECKLIST
LLOW - ALLOW, YELLOW, FOLLOW, FELLOW, PILLOW, HOLLOW, WILLOW
MANA - MANAGE, MANAGER, MANAGED, MANAGING, MANAGERS, MANAGEMENT
THIN - THINK, THING, WITHIN, THINGS, THINKS, THINKING, THINKPAD
TTLE - LITTLE, BATTLE, BOTTLE, CATTLE, SETTLE, SEATTLE, SHUTTLE
COME - COMES, BECOME, INCOME, COMEDY, WELCOME, OUTCOME, OVERCOME
ASED - BASED, PLEASED, RELEASED, INCREASED, PURCHASED, DECREASED
EVEN - EVENT, SEVEN, EVENTS, STEVEN, ELEVEN, EVENING, EVENTUALLY
SITE - SITES, WEBSITE, SITEMAP, OPPOSITE, COMPOSITE, PREREQUISITE
TTER - BETTER, LETTER, MATTER, POTTER, LATTER, BUTTER, NEWSLETTER
WRIT - WRITE, WRITER, WRITES, WRITTEN, WRITING, WRITERS, WRITINGS
COUR - COURT, COURSE, COURTS, COURSES, COURIER, COURAGE, COURTESY
BUIL - BUILD, BUILT, BUILDS, BUILDER, BUILDING, BUILDERS, BUILDINGS
RDER - ORDER, BORDER, MURDER, HARDER, RECORDER, DISORDER, CAMCORDER
SELE - SELECT, SELECTED, SELECTION, SELECTING, SELECTIVE, SELECTIONS
BASE - BASED, BASES, DATABASE, BASEBALL, BASELINE, BASEMENT, BASENAME
QUES - QUEST, QUESTION, ANTIQUES, QUESTIONS, TECHNIQUES, QUESTIONNAIRE
ADVA - ADVANCE, ADVANCED, ADVANCES, ADVANTAGE, ADVANTAGES, ADVANCEMENT
RARY - LIBRARY, LITERARY, CONTRARY, TEMPORARY, ARBITRARY, CONTEMPORARY
EDIA - MEDIA, EXPEDIA, WIKIPEDIA, MULTIMEDIA, MACROMEDIA, ENCYCLOPEDIA
ADDI - ADDING, ADDITION, ADDITIONS, ADDICTION, ADDITIONAL, ADDITIONALLY
POWE - POWER, POWERS, POWELL, POWERED, POWERFUL, POWERPOINT, POWERSELLER
SERV - SERVE, SERVER, SERVED, SERVES, SERVICE, SERVERS, SERVING, SERVICES
ARLY - EARLY, NEARLY, YEARLY, CLEARLY, REGULARLY, SIMILARLY, PARTICULARLY
RTED - SORTED, STARTED, REPORTED, IMPORTED, INSERTED, SUPPORTED, CONVERTED
ESTA - ESTATE, ESTATES, ESTABLISH, ESTABLISHED, ESTABLISHING, ESTABLISHMENT
MONT - MONTH, MONTE, MONTHS, MONTHLY, MONTANA, VERMONT, MONTREAL, MONTGOMERY
STUD - STUDY, STUDIO, STUDENT, STUDIES, STUDIOS, STUDIED, STUDENTS, STUDYING
STOR - STORE, STORY, STORM, STORES, STORED, PASTOR, STORIES, STORAGE, INVESTOR
TANT - INSTANT, DISTANT, CONSTANT, IMPORTANT, ASSISTANT, RESISTANT, CONSULTANT
PREV - PREVENT, PREVIEW, PREVIOUS, PREVIEWS, PREVENTION, PREVIOUSLY, PREVENTING
URAL - RURAL, NEURAL, NATURAL, CULTURAL, STRUCTURAL, AGRICULTURAL, ARCHITECTURAL
SITY - DENSITY, OBESITY, DIVERSITY, INTENSITY, NECESSITY, UNIVERSITY, BIODIVERSITY
REVI - REVIEW, REVIEWS, REVISED, REVIEWED, REVISION, REVIEWER, REVIEWING, REVISIONS
LACE - PLACE, PALACE, REPLACE, WALLACE, NECKLACE, WORKPLACE, FIREPLACE, MARKETPLACE
HOUS - HOUSE, HOUSES, HOUSING, HOUSTON, HOUSEHOLD, HOUSEWARES, HOUSEHOLDS, HOUSEWIVES
MBER - AMBER, NUMBER, MEMBER, TIMBER, CHAMBER, DECEMBER, NOVEMBER, REMEMBER, SEPTEMBER
PLAN - PLANS, PLANT, PLANE, PLANTS, PLANET, PLANES, PLANNED, PLANNER, PLANETS, PLANNING
VISI - VISIT, VISION, VISITS, VISITOR, VISIBLE, VISITED, VISITORS, VISITING, VISIBILITY
CERT - CERTAIN, CONCERT, CERTIFIED, CERTAINLY, CERTIFICATE, CERTIFICATES, CERTIFICATION
RESO - RESORT, RESORTS, RESOLVE, RESOURCE, RESOLVED, RESOURCES, RESOLUTION, RESOLUTIONS
ASES - CASES, BASES, PHASES, PHRASES, RELEASES, DISEASES, INCREASES, DATABASES, PURCHASES
EDIT - CREDIT, EDITOR, EDITED, EDITION, EDITORS, EDITING, EDITIONS, EDITORIAL, EDITORIALS
STAR - START, STARS, STARTS, STARTED, STARTER, STARTUP, STARTING, STARRING, STARSMERCHANT
FORM - FORMS, FORMAT, FORMER, REFORM, FORMAL, FORMED, PERFORM, FORMULA, FORMATS, PLATFORM
FORE - BEFORE, FOREST, FOREIGN, FOREVER, FORESTS, FORECAST, FORESTRY, THEREFORE, FORECASTS
IRED - TIRED, WIRED, FIRED, HIRED, DESIRED, RETIRED, EXPIRED, REQUIRED, ACQUIRED, INSPIRED
OUND - FOUND, SOUND, ROUND, BOUND, POUND, AROUND, GROUND, COMPOUND, BACKGROUND, UNDERGROUND
OPTI - OPTION, OPTICS, OPTIONS, OPTICAL, OPTIMAL, OPTIMUM, OPTIONAL, OPTIMIZE, OPTIMIZATION
TRAC - TRACK, TRACE, TRACY, TRACT, TRACKS, TRACKED, TRACKER, TRACKING, TRACKBACK, TRACKBACKS
NDER - UNDER, GENDER, WONDER, FINDER, SENDER, TENDER, FOUNDER, REMINDER, ALEXANDER, COMMANDER
RESS - PRESS, DRESS, STRESS, ADDRESS, EXPRESS, ACTRESS, PROGRESS, CONGRESS, MISTRESS, WORDPRESS
TRAV - TRAVEL, TRAVIS, TRAVELS, TRAVELER, TRAVESTI, TRAVELING, TRAVELERS, TRAVELLER, TRAVELLING
BREA - BREAK, BREAD, BREAST, BREAKS, BREATH, BREASTS, BREAKING, BREAKFAST, BREAKDOWN, BREATHING
LINE - LINES, ONLINE, LINEAR, OFFLINE, AIRLINE, MEDLINE, OUTLINE, PIPELINE, DEADLINE, DISCIPLINE
REAL - REALM, REALLY, REALTY, REALITY, REALIZE, REALTOR, MONTREAL, REALIZED, REALTORS, REALISTIC
POST - POSTS, POSTED, POSTER, POSTAL, POSTERS, POSTING, POSTAGE, POSTINGS, POSTCARDS, POSTPOSTED
WORK - WORKS, WORKED, WORKER, NETWORK, WORKING, WORKERS, WORKSHOP, FRAMEWORK, WORKSHOPS, WORKPLACE
AGES - PAGES, WAGES, IMAGES, STAGES, DAMAGES, MESSAGES, PACKAGES, LANGUAGES, MORTGAGES, ADVANTAGES
CHES - CHEST, INCHES, WATCHES, MATCHES, PATCHES, SEARCHES, CHURCHES, SWITCHES, BRANCHES, APPROACHES
YING - TRYING, BUYING, SAYING, PAYING, FLYING, PLAYING, CARRYING, APPLYING, DISPLAYING, IDENTIFYING
LING - MAILING, SELLING, CALLING, FEELING, WILLING, DEALING, HANDLING, LINGERIE, GAMBLING, STERLING
MARK - MARKS, MARKET, MARKED, MARKER, MARKETS, DENMARK, BOOKMARK, MARKETING, TRADEMARK, MARKETPLACE
TING - RATING, LISTING, MEETING, HOSTING, GETTING, WRITING, STARTING, EXISTING, MARKETING, OPERATING
EVER - EVERY, NEVER, HOWEVER, FOREVER, EVERYONE, WHATEVER, EVERYDAY, WHENEVER, EVERYBODY, EVERYTHING
NING - RUNNING, WARNING, MORNING, OPENING, EVENING, WINNING, TRAINING, LEARNING, PLANNING, BEGINNING
SURE - ENSURE, SURELY, MEASURE, LEISURE, CLOSURE, PRESSURE, EXPOSURE, PLEASURE, TREASURE, DISCLOSURE
CREA - CREAM, CREATE, CREATED, CREATES, CREATOR, CREATIVE, CREATING, CREATION, CREATURES, CREATIVITY
LIST - LISTS, LISTED, LISTEN, LISTING, LISTINGS, WISHLIST, PLAYLIST, LISTENING, CHECKLIST, SPECIALIST
BOOK - BOOKS, EBOOK, BOOKING, BOOKMARK, NOTEBOOK, HANDBOOK, COOKBOOK, GUESTBOOK, BOOKSTORE, BOOKMARKS
WARE - AWARE, ADWARE, SPYWARE, SOFTWARE, HARDWARE, DELAWARE, FREEWARE, FIRMWARE, WAREHOUSE, SHAREWARE
RIAL - TRIAL, SERIAL, AERIAL, MATERIAL, MEMORIAL, TUTORIAL, IMPERIAL, EDITORIAL, BACTERIAL, INDUSTRIAL
CONT - CONTACT, CONTROL, CONTENT, CONTEXT, CONTENTS, CONTINUE, CONTRACT, CONTAINS, CONTACTS, CONTINUED
STED - POSTED, LISTED, HOSTED, TESTED, TRUSTED, ADJUSTED, SUGGESTED, REQUESTED, INTERESTED, POSTPOSTED
CLAS - CLASS, CLASSIC, CLASSES, CLASSICS, CLASSICAL, CLASSROOM, CLASSIFIED, CLASSIFIEDS, CLASSIFICATION
THRE - THREE, THREAD, THREAT, THREADS, THREATS, THREADED, THRESHOLD, THREESOME, THREATENED, THREATENING
TURE - FUTURE, NATURE, MATURE, PICTURE, CULTURE, FEATURE, FURNITURE, STRUCTURE, LITERATURE, TEMPERATURE
RECE - RECENT, RECEIVE, RECEIPT, RECEIVED, RECENTLY, RECEIVER, RECEIVES, RECEPTOR, RECEIVING, RECEPTION
ACTI - ACTION, ACTIVE, ACTING, ACTIONS, ACTIVITY, ACTIVELY, ACTIVATED, ACTIVISTS, ACTIVITIES, ACTIVATION
MING - COMING, GAMING, TIMING, WYOMING, UPCOMING, BECOMING, SWIMMING, STREAMING, PERFORMING, PROGRAMMING
ANCE - DANCE, FRANCE, CHANCE, FINANCE, ADVANCE, DISTANCE, INSURANCE, ASSISTANCE, PERFORMANCE, MAINTENANCE
ABLE - TABLE, CABLE, ENABLE, VARIABLE, PORTABLE, AVAILABLE, PRINTABLE, APPLICABLE, REASONABLE, AFFORDABLE
HING - THING, NOTHING, FISHING, ANYTHING, CLOTHING, TEACHING, MATCHING, SOMETHING, EVERYTHING, PUBLISHING
SSES - LOSSES, PASSES, CLASSES, GLASSES, DRESSES, PROCESSES, ADDRESSES, WITNESSES, BUSINESSES, SUNGLASSES
PROV - PROVE, PROVIDE, PROVIDED, PROVIDES, PROVIDER, PROVINCE, PROVIDING, PROVIDERS, PROVISION, PROVISIONS
SUPP - SUPPLY, SUPPORT, SUPPLIES, SUPPLIED, SUPPORTS, SUPPLIER, SUPPOSED, SUPPORTED, SUPPLIERS, SUPPORTING
SIGN - SIGNS, DESIGN, SIGNED, SIGNAL, SIGNUP, SIGNALS, SIGNATURE, SIGNIFICANT, SIGNIFICANCE, SIGNIFICANTLY
CHAR - CHART, CHARGE, CHARTS, CHARLES, CHARGES, CHARGED, CHARACTER, CHARLOTTE, CHARACTERS, CHARACTERISTICS
RING - BRING, DURING, SPRING, STRING, HEARING, OFFERING, RINGTONES, MONITORING, ENGINEERING, MANUFACTURING
SOME - SOMEONE, AWESOME, SOMEHOW, SOMEWHAT, SOMEBODY, SOMERSET, SOMETHING, SOMETIMES, SOMEWHERE, THREESOME
ERED - POWERED, OFFERED, COVERED, ENTERED, ORDERED, ANSWERED, DELIVERED, REGISTERED, CONSIDERED, DISCOVERED
INED - JOINED, DEFINED, TRAINED, OBTAINED, COMBINED, REMAINED, CONTAINED, EXPLAINED, DETERMINED, MAINTAINED
ENTS - EVENTS, AGENTS, PARENTS, COMMENTS, STUDENTS, CONTENTS, PATIENTS, DOCUMENTS, COMPONENTS, REQUIREMENTS
ICAL - MEDICAL, MUSICAL, PHYSICAL, CRITICAL, CLINICAL, CHEMICAL, TECHNICAL, POLITICAL, HISTORICAL, ELECTRICAL
PROT - PROTEIN, PROTECT, PROTEST, PROTOCOL, PROTEINS, PROTECTED, PROTOCOLS, PROTECTION, PROTECTIVE, PROTECTING
RELA - RELAY, RELAX, RELATED, RELATIVE, RELATING, RELATION, RELATIONS, RELATIVELY, RELATIONSHIP, RELATIONSHIPS
PROP - PROPER, PROPOSE, PROPERTY, PROPOSED, PROPOSAL, PROPERLY, PROPOSALS, PROPERTIES, PROPORTION, PROPRIETARY
PERS - PERSON, PAPERS, PERSONS, PERSONAL, PERSONNEL, PERSONALS, DEVELOPERS, NEWSPAPERS, WALLPAPERS, PERSPECTIVE
ARCH - MARCH, SEARCH, ARCHIVE, RESEARCH, ARCHIVES, ARCHIVED, ARCHITECT, CITYSEARCH, ARCHITECTURE, ARCHITECTURAL
INDI - INDIA, INDIAN, INDIANA, INDICATE, INDICATED, INDICATES, INDIVIDUAL, INDICATORS, INDIVIDUALS, INDIANAPOLIS
RIES - SERIES, STORIES, ENTRIES, COUNTRIES, GALLERIES, LIBRARIES, BATTERIES, CATEGORIES, INDUSTRIES, ACCESSORIES
CONC - CONCEPT, CONCERN, CONCERT, CONCERNS, CONCEPTS, CONCRETE, CONCERNED, CONCERNING, CONCLUSION, CONCENTRATION
RESE - RESET, RESERVE, RESEARCH, RESERVED, RESERVES, RESELLER, RESEARCHER, RESERVATION, RESEARCHERS, RESERVATIONS
CATE - LOCATE, CATEGORY, INDICATE, CATERING, ADVOCATE, SYNDICATE, DUPLICATE, CATEGORIES, CERTIFICATE, COMMUNICATE
ALLY - REALLY, USUALLY, FINALLY, TOTALLY, ACTUALLY, GENERALLY, ESPECIALLY, ORIGINALLY, SPECIFICALLY, AUTOMATICALLY
PERF - PERFECT, PERFORM, PERFUME, PERFORMS, PERFORMED, PERFECTLY, PERFORMER, PERFORMING, PERFORMANCE, PERFORMANCES
NESS - FITNESS, WITNESS, ILLNESS, BUSINESS, WELLNESS, DARKNESS, AWARENESS, HAPPINESS, EFFECTIVENESS, CONSCIOUSNESS
TICS - OPTICS, CRITICS, POLITICS, GENETICS, ATHLETICS, LOGISTICS, COSMETICS, STATISTICS, MATHEMATICS, CHARACTERISTICS
TIAL - INITIAL, PARTIAL, SPATIAL, MARTIAL, POTENTIAL, ESSENTIAL, RESIDENTIAL, SUBSTANTIAL, CONFIDENTIAL, PRESIDENTIAL
COMM - COMMON, COMMENT, COMMAND, COMMENTS, COMMUNITY, COMMITTEE, COMMERCIAL, COMMISSION, COMMUNICATION, COMMUNICATIONS
INST - AGAINST, INSTEAD, INSTALL, INSTANT, INSTITUTE, INSTALLED, INSTRUMENTS, INSTRUCTIONS, INSTALLATION, INSTITUTIONS
DEVE - DEVEL, DEVELOP, DEVELOPS, DEVELOPED, DEVELOPER, DEVELOPING, DEVELOPERS, DEVELOPMENT, DEVELOPMENTS, DEVELOPMENTAL
RECO - RECORD, RECORDS, RECOVERY, RECORDED, RECOMMEND, RECORDING, RECOGNIZED, RECOMMENDED, RECOGNITION, RECOMMENDATIONS
LITY - QUALITY, ABILITY, REALITY, UTILITY, FACILITY, LIABILITY, DISABILITY, AVAILABILITY, ACCESSIBILITY, RESPONSIBILITY
CONF - CONFIG, CONFIRM, CONFLICT, CONFIRMED, CONFIGURE, CONFERENCE, CONFIDENCE, CONFERENCES, CONFIRMATION, CONFIGURATION
TIES - CITIES, PARTIES, UTILITIES, ACTIVITIES, FACILITIES, PROPERTIES, SECURITIES, COMMUNITIES, AUTHORITIES, OPPORTUNITIES
MENT - COMMENT, PAYMENT, EQUIPMENT, AGREEMENT, MANAGEMENT, GOVERNMENT, DEPARTMENT, DEVELOPMENT, ENVIRONMENT, ENTERTAINMENT
TECH - TECHNO, LOGITECH, TECHNICAL, TECHNIQUE, TECHNOLOGY, TECHNIQUES, TECHNICIAN, TECHNOLOGIES, TECHREPUBLIC, TECHNOLOGICAL
TRAN - TRANS, TRANSIT, TRANSFER, TRANSPORT, TRANSITION, TRANSLATION, TRANSACTION, TRANSMISSION, TRANSACTIONS, TRANSPORTATION
INVE - INVEST, INVESTOR, INVENTORY, INVESTORS, INVESTING, INVESTMENT, INVESTMENTS, INVESTIGATE, INVESTIGATION, INVESTIGATIONS
IONS - OPTIONS, QUESTIONS, SOLUTIONS, LOCATIONS, RELATIONS, CONDITIONS, OPERATIONS, APPLICATIONS, PUBLICATIONS, COMMUNICATIONS
ORGA - ORGAN, ORGANIC, ORGANIZE, ORGANIZED, ORGANIZING, ORGANIZATION, ORGANISATION, ORGANIZATIONS, ORGANISATIONS, ORGANIZATIONAL
RESP - RESPECT, RESPOND, RESPONSE, RESPONSES, RESPECTIVE, RESPONSIBLE, RESPONDENTS, RESPECTIVELY, RESPONSIBILITY, RESPONSIBILITIES
NCES - SCIENCES, REFERENCES, APPLIANCES, SUBSTANCES, DIFFERENCES, EXPERIENCES, PREFERENCES, CONFERENCES, CONSEQUENCES, CIRCUMSTANCES
THER - OTHER, THERE, OTHER, THERE, EITHER, RATHER, EITHER, RATHER, MOTHER, FATHER, GATHER, LUTHER, BOTHER, ANOTHER, FURTHER, WHETHER, WEATHER, ANOTHER, FURTHER, WHETHER, WEATHER, LEATHER, THERAPY, BROTHER, NEITHER, THERMAL, THEREOF, HEATHER, THEREBY, TOGETHER, TOGETHER, THEREFORE, THEREFORE, THERAPIST, THEREAFTER, THERAPEUTIC
