IGHT - RIGHT, NIGHT, LIGHT, MIGHT, EIGHT, FIGHT, WEIGHT, FLIGHT, STRAIGHT, COPYRIGHT
PLAN - PLANS, PLANT, PLANE, PLANTS, PLANET, PLANES, PLANNED, PLANNER, PLANETS, PLANNING
ANGE - RANGE, ANGEL, ANGER, CHANGE, ORANGE, ANGELS, ANGELES, STRANGE, ARRANGE, EXCHANGE
FORM - FORMS, FORMAT, FORMER, REFORM, FORMAL, FORMED, PERFORM, FORMULA, FORMATS, PLATFORM
CENT - CENTS, CENTER, RECENT, CENTRE, CENTRAL, PERCENT, CENTURY, CENTERS, CENTRES, VINCENT
OUND - FOUND, SOUND, ROUND, BOUND, POUND, AROUND, GROUND, COMPOUND, BACKGROUND, UNDERGROUND
THER - OTHER, THERE, EITHER, RATHER, ANOTHER, FURTHER, WHETHER, WEATHER, TOGETHER, THEREFORE
ORTS - PORTS, SPORTS, SHORTS, REPORTS, EFFORTS, RESORTS, IMPORTS, EXPORTS, SUPPORTS, AIRPORTS
NDER - UNDER, GENDER, WONDER, FINDER, SENDER, TENDER, FOUNDER, REMINDER, ALEXANDER, COMMANDER
NTER - ENTER, INTER, CENTER, WINTER, HUNTER, PRINTER, COUNTER, POINTER, PICHUNTER, MILFHUNTER
ARDS - CARDS, YARDS, BOARDS, AWARDS, TOWARDS, REGARDS, EDWARDS, REWARDS, STANDARDS, KEYBOARDS
PORT - SPORT, REPORT, PORTAL, IMPORT, EXPORT, SUPPORT, AIRPORT, PORTABLE, TRANSPORT, PORTFOLIO
ANDS - HANDS, BANDS, LANDS, BRANDS, STANDS, ISLANDS, DEMANDS, COMMANDS, THOUSANDS, NETHERLANDS
VING - HAVING, LIVING, MOVING, GIVING, SAVING, DRIVING, SERVING, LEAVING, RECEIVING, IMPROVING
STAT - STATE, STATS, STATES, STATUS, STATED, STATIC, STATION, STATEMENT, STATISTICS, STATEMENTS
RESS - PRESS, DRESS, STRESS, ADDRESS, EXPRESS, ACTRESS, PROGRESS, CONGRESS, MISTRESS, WORDPRESS
MODE - MODEL, MODEM, MODES, MODELS, MODERN, MODELING, MODERATE, MODERATOR, MODELLING, MODERATORS
LINE - LINES, ONLINE, LINEAR, OFFLINE, AIRLINE, MEDLINE, OUTLINE, PIPELINE, DEADLINE, DISCIPLINE
POST - POSTS, POSTED, POSTER, POSTAL, POSTERS, POSTING, POSTAGE, POSTINGS, POSTCARDS, POSTPOSTED
WING - WINGS, SWING, SHOWING, GROWING, VIEWING, DRAWING, KNOWING, ALLOWING, FOLLOWING, REVIEWING
VIEW - VIEWS, REVIEW, VIEWED, VIEWER, VIEWING, PREVIEW, VIEWERS, OVERVIEW, INTERVIEW, VIEWPICTURE
KING - MAKING, TAKING, LOOKING, WORKING, KINGDOM, FUCKING, TALKING, PARKING, THINKING, NETWORKING
COUN - COUNT, COUNTY, COUNTS, COUNTRY, COUNCIL, COUNTER, COUNSEL, COUNTIES, COUNTRIES, COUNSELING
AGES - PAGES, WAGES, IMAGES, STAGES, DAMAGES, MESSAGES, PACKAGES, LANGUAGES, MORTGAGES, ADVANTAGES
WORK - WORKS, WORKED, WORKER, NETWORK, WORKING, WORKERS, WORKSHOP, FRAMEWORK, WORKSHOPS, WORKPLACE
STER - MASTER, POSTER, FASTER, SISTER, MONSTER, REGISTER, MINISTER, STERLING, WEBMASTER, MANCHESTER
ITED - CITED, UNITED, EDITED, LIMITED, VISITED, INVITED, EXCITED, UNLIMITED, PROHIBITED, ACCREDITED
YING - TRYING, BUYING, SAYING, PAYING, FLYING, PLAYING, CARRYING, APPLYING, DISPLAYING, IDENTIFYING
LING - MAILING, SELLING, CALLING, FEELING, WILLING, DEALING, HANDLING, LINGERIE, GAMBLING, STERLING
MARK - MARKS, MARKET, MARKED, MARKER, MARKETS, DENMARK, BOOKMARK, MARKETING, TRADEMARK, MARKETPLACE
CTOR - ACTOR, SECTOR, DOCTOR, FACTOR, VECTOR, DIRECTOR, COLLECTOR, CONNECTOR, CONTRACTOR, INSTRUCTOR
TING - RATING, LISTING, MEETING, HOSTING, GETTING, WRITING, STARTING, EXISTING, MARKETING, OPERATING
GHTS - RIGHTS, LIGHTS, NIGHTS, FLIGHTS, HEIGHTS, WEIGHTS, THOUGHTS, INSIGHTS, HIGHLIGHTS, COPYRIGHTS
CREA - CREAM, CREATE, CREATED, CREATES, CREATOR, CREATIVE, CREATING, CREATION, CREATURES, CREATIVITY
HERE - THERE, WHERE, HEREIN, HEREBY, NOWHERE, ANYWHERE, ELSEWHERE, SOMEWHERE, ATMOSPHERE, EVERYWHERE
NING - RUNNING, WARNING, MORNING, OPENING, EVENING, WINNING, TRAINING, LEARNING, PLANNING, BEGINNING
PRIN - PRINT, PRINTS, PRINCE, PRINTER, PRINTED, PRINTING, PRINTERS, PRINCIPAL, PRINTABLE, PRINCIPLES
EVER - EVERY, NEVER, HOWEVER, FOREVER, EVERYONE, WHATEVER, EVERYDAY, WHENEVER, EVERYBODY, EVERYTHING
CHAN - CHANGE, CHANCE, CHANGES, CHANNEL, CHANGED, CHANCES, CHANGING, CHANNELS, CHANGELOG, CHANCELLOR
LIST - LISTS, LISTED, LISTEN, LISTING, LISTINGS, WISHLIST, PLAYLIST, LISTENING, CHECKLIST, SPECIALIST
BOOK - BOOKS, EBOOK, BOOKING, BOOKMARK, NOTEBOOK, HANDBOOK, COOKBOOK, GUESTBOOK, BOOKSTORE, BOOKMARKS
INGS - RINGS, THINGS, RATINGS, SAVINGS, SPRINGS, LISTINGS, SETTINGS, MEETINGS, BUILDINGS, PROCEEDINGS
PING - HOPING, KEEPING, HELPING, MAPPING, CAMPING, SHIPPING, SHOPPING, SLEEPING, WRAPPING, DEVELOPING
WARE - AWARE, ADWARE, SPYWARE, SOFTWARE, HARDWARE, DELAWARE, FREEWARE, FIRMWARE, WAREHOUSE, SHAREWARE
CONT - CONTACT, CONTROL, CONTENT, CONTEXT, CONTENTS, CONTINUE, CONTRACT, CONTAINS, CONTACTS, CONTINUED
STED - POSTED, LISTED, HOSTED, TESTED, TRUSTED, ADJUSTED, SUGGESTED, REQUESTED, INTERESTED, POSTPOSTED
MEDI - MEDIA, MEDIUM, MEDIAN, MEDICAL, MEDICINE, MEDICARE, MEDIEVAL, MEDICAID, MEDICATION, MEDICATIONS
RIAL - TRIAL, SERIAL, AERIAL, MATERIAL, MEMORIAL, TUTORIAL, IMPERIAL, EDITORIAL, BACTERIAL, INDUSTRIAL
THRE - THREE, THREAD, THREAT, THREADS, THREATS, THREADED, THRESHOLD, THREESOME, THREATENED, THREATENING
RECE - RECENT, RECEIVE, RECEIPT, RECEIVED, RECENTLY, RECEIVER, RECEIVES, RECEPTOR, RECEIVING, RECEPTION
ECTS - EFFECTS, OBJECTS, ASPECTS, AFFECTS, DEFECTS, PROJECTS, SUBJECTS, REFLECTS, PROSPECTS, ARCHITECTS
TURE - FUTURE, NATURE, MATURE, PICTURE, CULTURE, FEATURE, FURNITURE, STRUCTURE, LITERATURE, TEMPERATURE
SING - USING, SINGLE, HOUSING, NURSING, MISSING, SINGLES, SINGAPORE, PROCESSING, INCREASING, ADVERTISING
ACTI - ACTION, ACTIVE, ACTING, ACTIONS, ACTIVITY, ACTIVELY, ACTIVATED, ACTIVISTS, ACTIVITIES, ACTIVATION
GENE - GENES, GENERAL, GENERIC, GENETIC, GENERATE, GENETICS, GENERALLY, GENERATED, GENERATOR, GENERATION
LAND - ISLAND, ENGLAND, IRELAND, ZEALAND, MARYLAND, SCOTLAND, THAILAND, PORTLAND, LANDSCAPE, SWITZERLAND
ABLE - TABLE, CABLE, ENABLE, VARIABLE, PORTABLE, AVAILABLE, PRINTABLE, APPLICABLE, REASONABLE, AFFORDABLE
HING - THING, NOTHING, FISHING, ANYTHING, CLOTHING, TEACHING, MATCHING, SOMETHING, EVERYTHING, PUBLISHING
ANCE - DANCE, FRANCE, CHANCE, FINANCE, ADVANCE, DISTANCE, INSURANCE, ASSISTANCE, PERFORMANCE, MAINTENANCE
STAN - STAND, STANDS, STANLEY, STANDARD, STANDING, PAKISTAN, STANFORD, STANDARDS, KAZAKHSTAN, AFGHANISTAN
CHAR - CHART, CHARGE, CHARTS, CHARLES, CHARGES, CHARGED, CHARACTER, CHARLOTTE, CHARACTERS, CHARACTERISTICS
ATED - RATED, RELATED, UPDATED, CREATED, LOCATED, GENERATED, DEDICATED, ASSOCIATED, DESIGNATED, INTEGRATED
RING - BRING, DURING, SPRING, STRING, HEARING, OFFERING, RINGTONES, MONITORING, ENGINEERING, MANUFACTURING
SUPP - SUPPLY, SUPPORT, SUPPLIES, SUPPLIED, SUPPORTS, SUPPLIER, SUPPOSED, SUPPORTED, SUPPLIERS, SUPPORTING
PROV - PROVE, PROVIDE, PROVIDED, PROVIDES, PROVIDER, PROVINCE, PROVIDING, PROVIDERS, PROVISION, PROVISIONS
CIAL - SOCIAL, CIALIS, FACIAL, SPECIAL, OFFICIAL, JUDICIAL, FINANCIAL, COMMERCIAL, ARTIFICIAL, INTERRACIAL
DESI - DESIGN, DESIRE, DESIGNS, DESIRED, DESIGNED, DESIGNER, DESIGNERS, DESIGNING, DESIGNATED, DESIGNATION
IOUS - VARIOUS, SERIOUS, OBVIOUS, CURIOUS, PREVIOUS, PRECIOUS, RELIGIOUS, DELICIOUS, CONSCIOUS, INFECTIOUS
INED - JOINED, DEFINED, TRAINED, OBTAINED, COMBINED, REMAINED, CONTAINED, EXPLAINED, DETERMINED, MAINTAINED
ENTS - EVENTS, AGENTS, PARENTS, COMMENTS, STUDENTS, CONTENTS, PATIENTS, DOCUMENTS, COMPONENTS, REQUIREMENTS
TORY - STORY, HISTORY, FACTORY, VICTORY, DIRECTORY, INVENTORY, TERRITORY, STATUTORY, LABORATORY, REGULATORY
ERED - POWERED, OFFERED, COVERED, ENTERED, ORDERED, ANSWERED, DELIVERED, REGISTERED, CONSIDERED, DISCOVERED
INES - LINES, WINES, ENGINES, MACHINES, AIRLINES, MAGAZINES, HEADLINES, GUIDELINES, LIMOUSINES, PHILIPPINES
RITY - CHARITY, CLARITY, SECURITY, PRIORITY, MAJORITY, MINORITY, AUTHORITY, CELEBRITY, INTEGRITY, POPULARITY
SION - VISION, VERSION, SESSION, MISSION, DECISION, DIVISION, DISCUSSION, COMMISSION, TELEVISION, PERMISSION
COMP - COMPANY, COMPARE, COMPLEX, COMPUTER, COMPLETE, COMPANIES, COMPUTERS, COMPLETED, COMPONENT, COMPONENTS
ATES - RATES, DATES, STATES, UPDATES, ESTIMATES, INDICATES, ASSOCIATES, AFFILIATES, CANDIDATES, CERTIFICATES
TERS - LETTERS, CENTERS, POSTERS, MATTERS, WRITERS, PRINTERS, COMPUTERS, CHARACTERS, PARAMETERS, NEWSLETTERS
APPL - APPLY, APPLE, APPLIED, APPLIES, APPLYING, APPLICANT, APPLICABLE, APPLIANCES, APPLICATION, APPLICATIONS
ICAL - MEDICAL, MUSICAL, PHYSICAL, CRITICAL, CLINICAL, CHEMICAL, TECHNICAL, POLITICAL, HISTORICAL, ELECTRICAL
TORS - FACTORS, EDITORS, DOCTORS, VISITORS, MONITORS, DIRECTORS, OPERATORS, INVESTORS, INDICATORS, CONTRACTORS
CTED - ELECTED, SELECTED, EXPECTED, DIRECTED, AFFECTED, PROTECTED, CONNECTED, CONDUCTED, COLLECTED, RESTRICTED
DING - READING, WEDDING, LEADING, FUNDING, BUILDING, INCLUDING, ACCORDING, PROVIDING, REGARDING, UNDERSTANDING
PROP - PROPER, PROPOSE, PROPERTY, PROPOSED, PROPOSAL, PROPERLY, PROPOSALS, PROPERTIES, PROPORTION, PROPRIETARY
COND - CONDO, SECOND, CONDOS, CONDUCT, CONDITION, CONDUCTED, CONDITIONS, CONDUCTING, CONDITIONAL, CONDITIONING
RELA - RELAY, RELAX, RELATED, RELATIVE, RELATING, RELATION, RELATIONS, RELATIVELY, RELATIONSHIP, RELATIONSHIPS
DENT - DENTAL, STUDENT, ACCIDENT, RESIDENT, INCIDENT, PRESIDENT, DEPENDENT, CONFIDENT, RESPONDENT, INDEPENDENT
ARCH - MARCH, SEARCH, ARCHIVE, RESEARCH, ARCHIVES, ARCHIVED, ARCHITECT, CITYSEARCH, ARCHITECTURE, ARCHITECTURAL
PERS - PERSON, PAPERS, PERSONS, PERSONAL, PERSONNEL, PERSONALS, DEVELOPERS, NEWSPAPERS, WALLPAPERS, PERSPECTIVE
IBLE - BIBLE, VISIBLE, POSSIBLE, ELIGIBLE, FLEXIBLE, COMPATIBLE, ACCESSIBLE, IMPOSSIBLE, INCREDIBLE, RESPONSIBLE
INDI - INDIA, INDIAN, INDIANA, INDICATE, INDICATED, INDICATES, INDIVIDUAL, INDICATORS, INDIVIDUALS, INDIANAPOLIS
RIES - SERIES, STORIES, ENTRIES, COUNTRIES, GALLERIES, LIBRARIES, BATTERIES, CATEGORIES, INDUSTRIES, ACCESSORIES
DIRE - DIRECT, DIRECTOR, DIRECTLY, DIRECTED, DIRECTORY, DIRECTION, DIRECTORS, DIRECTIVE, DIRECTIONS, DIRECTORIES
RESE - RESET, RESERVE, RESEARCH, RESERVED, RESERVES, RESELLER, RESEARCHER, RESERVATION, RESEARCHERS, RESERVATIONS
CATE - LOCATE, CATEGORY, INDICATE, CATERING, ADVOCATE, SYNDICATE, DUPLICATE, CATEGORIES, CERTIFICATE, COMMUNICATE
EXPE - EXPERT, EXPECT, EXPERTS, EXPECTED, EXPENSES, EXPENSIVE, EXPERIENCE, EXPERIENCED, EXPERIENCES, EXPERIMENTAL
URES - FIGURES, PICTURES, FEATURES, MEASURES, CULTURES, LECTURES, PROCEDURES, STRUCTURES, ADVENTURES, EXPENDITURES
TION - ACTION, SECTION, EDITION, LOCATION, QUESTION, EDUCATION, INFORMATION, DESCRIPTION, APPLICATION, ASSOCIATION
SPEC - SPECS, SPECIAL, SPECIES, SPECIFIC, SPECIALS, SPECIFIED, SPECIALTY, SPECIALIST, SPECIFICALLY, SPECIFICATIONS
PROD - PRODUCT, PRODUCE, PRODUCTS, PRODUCED, PRODUCER, PRODUCING, PRODUCERS, PRODUCTION, PRODUCTIONS, PRODUCTIVITY
ALLY - REALLY, USUALLY, FINALLY, TOTALLY, ACTUALLY, GENERALLY, ESPECIALLY, ORIGINALLY, SPECIFICALLY, AUTOMATICALLY
ELEC - ELECTED, ELECTRO, ELECTRIC, ELECTION, ELECTRON, ELECTIONS, ELECTRONIC, ELECTRICAL, ELECTRONICS, ELECTRICITY
NESS - FITNESS, WITNESS, ILLNESS, BUSINESS, WELLNESS, DARKNESS, AWARENESS, HAPPINESS, EFFECTIVENESS, CONSCIOUSNESS
REQU - REQUEST, REQUIRE, REQUIRED, REQUIRES, REQUESTS, REQUESTED, REQUIRING, REQUESTING, REQUIREMENT, REQUIREMENTS
PART - PARTY, PARTS, PARTNER, PARTIES, PARTNERS, PARTICULAR, PARTNERSHIP, PARTICULARLY, PARTICIPANTS, PARTICIPATION
ENCE - SCIENCE, EVIDENCE, SEQUENCE, VIOLENCE, PRESENCE, REFERENCE, EXPERIENCE, CONFERENCE, DIFFERENCE, INTELLIGENCE
PUBL - PUBLIC, PUBLISH, PUBLICLY, PUBLISHED, PUBLISHER, PUBLICITY, PUBLISHING, PUBLISHERS, PUBLICATION, PUBLICATIONS
ACCE - ACCESS, ACCEPT, ACCEPTED, ACCESSED, ACCESSORY, ACCEPTANCE, ACCESSIBLE, ACCEPTABLE, ACCESSORIES, ACCESSIBILITY
PRES - PRESS, PRESENT, PRESSURE, PRESENCE, PRESENTS, PRESIDENT, PRESENTED, PRESENTATION, PRESCRIPTION, PRESENTATIONS
PROC - PROCESS, PROCEED, PROCESSES, PROCEDURE, PROCESSOR, PROCESSED, PROCESSING, PROCEDURES, PROCESSORS, PROCEEDINGS
DISC - DISCUSS, DISCOUNT, DISCOVER, DISCUSSED, DISCOVERY, DISCOUNTS, DISCUSSION, DISCLAIMER, DISCOVERED, DISCUSSIONS
IVES - GIVES, LIVES, DRIVES, ARCHIVES, RECEIVES, OBJECTIVES, INITIATIVES, ALTERNATIVES, PERSPECTIVES, REPRESENTATIVES
APPR - APPROX, APPROVE, APPROACH, APPROVED, APPROVAL, APPROACHES, APPRECIATE, APPROPRIATE, APPRECIATED, APPROXIMATELY
COMM - COMMON, COMMENT, COMMAND, COMMENTS, COMMUNITY, COMMITTEE, COMMERCIAL, COMMISSION, COMMUNICATION, COMMUNICATIONS
INST - AGAINST, INSTEAD, INSTALL, INSTANT, INSTITUTE, INSTALLED, INSTRUMENTS, INSTRUCTIONS, INSTALLATION, INSTITUTIONS
RECO - RECORD, RECORDS, RECOVERY, RECORDED, RECOMMEND, RECORDING, RECOGNIZED, RECOMMENDED, RECOGNITION, RECOMMENDATIONS
DEVE - DEVEL, DEVELOP, DEVELOPS, DEVELOPED, DEVELOPER, DEVELOPING, DEVELOPERS, DEVELOPMENT, DEVELOPMENTS, DEVELOPMENTAL
INTE - INTERNET, INTEREST, INTERNAL, INTENDED, INTERFACE, INTERESTS, INTERESTED, INTEGRATED, INTERESTING, INTERNATIONAL
LITY - QUALITY, ABILITY, REALITY, UTILITY, FACILITY, LIABILITY, DISABILITY, AVAILABILITY, ACCESSIBILITY, RESPONSIBILITY
LOGY - BIOLOGY, ECOLOGY, GENEALOGY, PATHOLOGY, SOCIOLOGY, TECHNOLOGY, PSYCHOLOGY, PHYSIOLOGY, METHODOLOGY, BIOTECHNOLOGY
CONF - CONFIG, CONFIRM, CONFLICT, CONFIRMED, CONFIGURE, CONFERENCE, CONFIDENCE, CONFERENCES, CONFIRMATION, CONFIGURATION
SHIP - SHIPS, SHIPPED, SHIPPING, OWNERSHIP, MEMBERSHIP, LEADERSHIP, PARTNERSHIP, SCHOLARSHIP, RELATIONSHIP, CHAMPIONSHIP
COLL - COLLEGE, COLLECT, COLLINS, COLLEGES, COLLECTED, COLLECTION, COLLECTIONS, COLLECTIBLES, COLLECTABLES, COLLABORATION
TIVE - ACTIVE, POSITIVE, CREATIVE, EFFECTIVE, EXECUTIVE, RESPECTIVE, AUTOMOTIVE, ALTERNATIVE, INTERACTIVE, ADMINISTRATIVE
MENT - COMMENT, PAYMENT, EQUIPMENT, AGREEMENT, MANAGEMENT, GOVERNMENT, DEPARTMENT, DEVELOPMENT, ENVIRONMENT, ENTERTAINMENT
TIES - CITIES, PARTIES, UTILITIES, ACTIVITIES, FACILITIES, PROPERTIES, SECURITIES, COMMUNITIES, AUTHORITIES, OPPORTUNITIES
DIFF - DIFFER, CARDIFF, DIFFERENT, DIFFICULT, DIFFERENCE, DIFFICULTY, DIFFERENCES, DIFFERENTLY, DIFFICULTIES, DIFFERENTIAL
CONS - CONSUMER, CONSIDER, CONSTANT, CONSUMERS, CONSIDERED, CONSULTING, CONSISTENT, CONSTITUTES, CONSTRUCTION, CONSERVATION
TRAN - TRANS, TRANSIT, TRANSFER, TRANSPORT, TRANSITION, TRANSLATION, TRANSACTION, TRANSMISSION, TRANSACTIONS, TRANSPORTATION
TECH - TECHNO, LOGITECH, TECHNICAL, TECHNIQUE, TECHNOLOGY, TECHNIQUES, TECHNICIAN, TECHNOLOGIES, TECHREPUBLIC, TECHNOLOGICAL
ONAL - NATIONAL, PERSONAL, REGIONAL, OPTIONAL, ADDITIONAL, FUNCTIONAL, EDUCATIONAL, TRADITIONAL, PROFESSIONAL, INTERNATIONAL
UNDE - UNDER, UNDERWEAR, UNDEFINED, UNDERSTAND, UNDERSTOOD, UNDERLYING, UNDERTAKEN, UNDERGROUND, UNDERSTANDING, UNDERGRADUATE
IONS - OPTIONS, QUESTIONS, SOLUTIONS, LOCATIONS, RELATIONS, CONDITIONS, OPERATIONS, APPLICATIONS, PUBLICATIONS, COMMUNICATIONS
DIST - DISTRICT, DISTANCE, DISTINCT, DISTRICTS, DISTRIBUTE, DISTRIBUTED, DISTRIBUTOR, DISTRIBUTION, DISTRIBUTORS, DISTINGUISHED
ACCO - ACCOUNT, TOBACCO, ACCOUNTS, ACCORDING, ACCOUNTING, ACCORDANCE, ACCORDINGLY, ACCOMMODATION, ACCOMMODATIONS, ACCOUNTABILITY
RESP - RESPECT, RESPOND, RESPONSE, RESPONSES, RESPECTIVE, RESPONSIBLE, RESPONDENTS, RESPECTIVELY, RESPONSIBILITY, RESPONSIBILITIES
NCES - SCIENCES, REFERENCES, APPLIANCES, SUBSTANCES, DIFFERENCES, EXPERIENCES, PREFERENCES, CONFERENCES, CONSEQUENCES, CIRCUMSTANCES
